sujoy ghosh department::sujoy ghosh department
department of computer::department of computer
science and engineering::science and engineering
day so ttoday::day so ttoday
fiber optic communication::fiber optic communication
heard tthis lecture::heard tthis lecture
couple of lectures::couple of lectures
lectures will concentrate::lectures will concentrate
concentrate on fiber::concentrate on fiber
fiber optic components::fiber optic components
fiber optic systems::fiber optic systems
talking about today::talking about today
wavelength division multiplexing::wavelength division multiplexing
multiplexing is done::multiplexing is done
handled in fiber::handled in fiber
fiber optic domain::fiber optic domain
domain tthe fiber::domain tthe fiber
tthe fiber optic::tthe fiber optic
traffic in terms::traffic in terms
terms of volume::terms of volume
forty to fifty::forty to fifty
fiber as days::fiber as days
demand for bandwidth::demand for bandwidth
talking about fiber::talking about fiber
optic components today::optic components today
sso in fiber::sso in fiber
fiber optic component::fiber optic component
talk little bit::talk little bit
sources and receivers::sources and receivers
carrier of information::carrier of information
components like amplifiers::components like amplifiers
multiplexers and switches::multiplexers and switches
start our discussion::start our discussion
discussion on wavelength::discussion on wavelength
sso optical fiber::sso optical fiber
transparent silica glass::transparent silica glass
aat a moderate::aat a moderate
light is restricted::light is restricted
total internal reflection::total internal reflection
reflection for ordinary::reflection for ordinary
fiber ok mmf::fiber ok mmf
lans for low::lans for low
speeds or short::speeds or short
kind of fiber::kind of fiber
bbut the multimode::bbut the multimode
low speed wwhen::low speed wwhen
comparatively low speed::comparatively low speed
mbps or hundred::mbps or hundred
hundred and fifty::hundred and fifty
fifty five mbps::fifty five mbps
couple of kilometers::couple of kilometers
carries the signal::carries the signal
remember our discussion::remember our discussion
fibers in physical::fibers in physical
shown some diagrams::shown some diagrams
strand of glass::strand of glass
glass fiber tthis::glass fiber tthis
tthis is surrounded::tthis is surrounded
made of glass::made of glass
carrying the signal::carrying the signal
signal tthe surrounding::signal tthe surrounding
coated or covered::coated or covered
tthen it acts::tthen it acts
mode of operations::mode of operations
details of eelectro::details of eelectro
mmagnetics and wave::mmagnetics and wave
wave guide propagation::wave guide propagation
propagation of optics::propagation of optics
mode of propagation::mode of propagation
single mode fiber::single mode fiber
mode fiber smf::mode fiber smf
fibers which span::fibers which span
span across oceans::span across oceans
marvel of engineering::marvel of engineering
engineering and technology::engineering and technology
single mode fibers::single mode fibers
fifteen fifty nanometer::fifteen fifty nanometer
window is preferred::window is preferred
long haul applications::long haul applications
easily get good::easily get good
good optical amplifiers::good optical amplifiers
fifteen fifty nanometer1550::fifteen fifty nanometer1550
nanometer1550 nm range::nanometer1550 nm range
kind of low::kind of low
nanometeris another window::nanometeris another window
discuss optical amplifiers::discuss optical amplifiers
require optical amplifiers::require optical amplifiers
losses in fiber,losses::losses in fiber,losses
fiber,losses in fiber::fiber,losses in fiber
thing is absorption::thing is absorption
atom and absorbs::atom and absorbs
magnitude or lower::magnitude or lower
longer and longer::longer and longer
scattering of photons::scattering of photons
due to slight::due to slight
index of glass::index of glass
mie scattering due::mie scattering due
due to imperfection::due to imperfection
made to rigorous::made to rigorous
types of scattering::types of scattering
leading to losses::leading to losses
losses in fiber::losses in fiber
lowering of signal::lowering of signal
means that tthe::means that tthe
frequency the trouble::frequency the trouble
specially a digital::specially a digital
lot of spectral::lot of spectral
harmonics or components::harmonics or components
perfect square shape::perfect square shape
specific strengths compared::specific strengths compared
ddue to differential::ddue to differential
shape has changed::shape has changed
dispersion ? chromatic::dispersion ? chromatic
wavelength or frequency::wavelength or frequency
chromatic different spectral::chromatic different spectral
components of pulse::components of pulse
group velocity dispersion::group velocity dispersion
dispersion so wwe::dispersion so wwe
kind of velocity::kind of velocity
kind of dispersion::kind of dispersion
fiber for compensating::fiber for compensating
compensating these dispersions::compensating these dispersions
nowadays some special::nowadays some special
types of fibers::types of fibers
reduced dispersion fiber::reduced dispersion fiber
fiber by dispersion::fiber by dispersion
dispersion shifted fibers::dispersion shifted fibers
sort of acted::sort of acted
acted on nonzero::acted on nonzero
nonzero dispersion shifted::nonzero dispersion shifted
ninety five percent95::ninety five percent95
deployed plant dispersion::deployed plant dispersion
dispersion is measured::dispersion is measured
measured in pico::measured in pico
fiber these days::fiber these days
short haul applications::short haul applications
bother about dispersion::bother about dispersion
dispersion shifted characteristics::dispersion shifted characteristics
bandwidth span product::bandwidth span product
kind of distance::kind of distance
kinds of transmission::kinds of transmission
sso a transmission::sso a transmission
increase the rate::increase the rate
increase the frequency::increase the frequency
data rate constant::data rate constant
constant and increase::constant and increase
increase the length::increase the length
kind of medium::kind of medium
bandwidth distance product::bandwidth distance product
sort of constant::sort of constant
speed for lets::speed for lets
double the data::double the data
kind of smf::kind of smf
point five giga::point five giga
forty kilometers640 kms::forty kilometers640 kms
kms without amplification::kms without amplification
kms a decent::kms a decent
four hundred kilometers::four hundred kilometers
kms,ok which spans::kms,ok which spans
ten giga bits::ten giga bits
multiply these figures::multiply these figures
figures for dwdm::figures for dwdm
talk about wdm::talk about wdm
number of channels::number of channels
realize really tremendous::realize really tremendous
tremendous data rate::tremendous data rate
high data rate::high data rate
advantage of fiber::advantage of fiber
susceptible to electromagnetic::susceptible to electromagnetic
thing because nowadays::thing because nowadays
noisy electromagnetic ambience::noisy electromagnetic ambience
fiber is immune::fiber is immune
point about fiber::point about fiber
led light source::led light source
multi mode fiber::multi mode fiber
fiber or single::fiber or single
led one good::led one good
sso the good::sso the good
thing about multi::thing about multi
product an led::product an led
forward biased pn-junction::forward biased pn-junction
recombination of injected::recombination of injected
injected minority carriers::injected minority carriers
carriers by spontaneous::carriers by spontaneous
spontaneous emission produces::spontaneous emission produces
emission produces light::emission produces light
power ok power::power ok power
power you remember::power you remember
source of light::source of light
comparatively low power::comparatively low power
power like twenty::power like twenty
low internal modulation::low internal modulation
hundreds of mega::hundreds of mega
core of wide::core of wide
wide area network::wide area network
fibers or leds::fibers or leds
leds led slicing::leds led slicing
slicing is led::slicing is led
kind of light::kind of light
higher power output::higher power output
pulses of light::pulses of light
high power output::high power output
range of spectrum::range of spectrum
laser that reduces::laser that reduces
reduces the chromatic::reduces the chromatic
good for longer::good for longer
distances and larger::distances and larger
larger bit rates::larger bit rates
bit rates compared::bit rates compared
compared to mlm::compared to mlm
bother about mlm::bother about mlm
kind of devices::kind of devices
tunable lasers tunable::tunable lasers tunable
lasers tunable lasers::lasers tunable lasers
tunable lasers means::tunable lasers means
means a laser::means a laser
change the color::change the color
color of light::color of light
require for tuning::require for tuning
milliseconds ? range::milliseconds ? range
order of milliseconds::order of milliseconds
change the frequency::change the frequency
wide and continuous::wide and continuous
stable over lifetime::stable over lifetime
controllable and manufacturable::controllable and manufacturable
optical ; changing::optical ; changing
changing the refractive::changing the refractive
index by injecting::index by injecting
injecting the current::injecting the current
current or applying::current or applying
applying an electromagnetic::applying an electromagnetic
electromagnetic field sso::electromagnetic field sso
range is narrow::range is narrow
degrade the lifetime::degrade the lifetime
tuning using mems::tuning using mems
slightly more complex::slightly more complex
complex to manage::complex to manage
mention this point::mention this point
discuss wdm wdm::discuss wdm wdm
light pulse coming::light pulse coming
sort of push::sort of push
conduction band sso::conduction band sso
standard photo detector::standard photo detector
studied at school::studied at school
sort of higher::sort of higher
mentioning that nowadays::mentioning that nowadays
running for thousands::running for thousands
thousands of kilometers::thousands of kilometers
long haul fibers::long haul fibers
previously this distance::previously this distance
four five kilometers::four five kilometers
5kms ok nnowadays::5kms ok nnowadays
twenty five kilometers::twenty five kilometers
hundreds of kilometers::hundreds of kilometers
amplify the signal::amplify the signal
signal for optical::signal for optical
optical signals traveling::optical signals traveling
traveling long distance::traveling long distance
distance through fiber::distance through fiber
done through olt::done through olt
technology in olt::technology in olt
signal was converted::signal was converted
number of disadvantages::number of disadvantages
disadvantage being cost::disadvantage being cost
cost is higher::cost is higher
higher and speed::higher and speed
speed is lower::speed is lower
done in optical::done in optical
domain the idea::domain the idea
domain through erbium::domain through erbium
erbium doped fiber::erbium doped fiber
doped fiber amplifiers::doped fiber amplifiers
kinds of dopers::kinds of dopers
propagates with distance::propagates with distance
minimum operating level::minimum operating level
sort of decay::sort of decay
kind of repeaters::kind of repeaters
point where simple::point where simple
reshape and retime::reshape and retime
absorption is concerned::absorption is concerned
increase the size::increase the size
signal is good::signal is good
loss of strength::loss of strength
due to chromatic::due to chromatic
amount of errors::amount of errors
wave into shape::wave into shape
kinds of fibers::kinds of fibers
today to bring::today to bring
right square shape::right square shape
kind of regeneration::kind of regeneration
domain we amplify::domain we amplify
nicely shaped pulse::nicely shaped pulse
reshaped the problem::reshaped the problem
cost is high::cost is high
inherently can operate::inherently can operate
fairly high-speed electronics::fairly high-speed electronics
speed becomes higher::speed becomes higher
higher and higher::higher and higher
number of schemes::number of schemes
today for handling::today for handling
specially shaped optical::specially shaped optical
shaped optical waves::shaped optical waves
sort of done::sort of done
components are mixed::components are mixed
fibers which give::fibers which give
give the dispersion::give the dispersion
back to shape::back to shape
atoms to handle::atoms to handle
handle this reshaping::handle this reshaping
widely deployed system::widely deployed system
regenerators are specific::regenerators are specific
specific bit rate::specific bit rate
rate and modulation::rate and modulation
thing about optical::thing about optical
amplifiers the system::amplifiers the system
system with optical::system with optical
upgraded to higher::upgraded to higher
higher bit rate::higher bit rate
replacing the amplifiers::replacing the amplifiers
infrastructure for higher::infrastructure for higher
rate as service::rate as service
replace optical amplifiers::replace optical amplifiers
amplifiers have large::amplifiers have large
large gain bandwidth::large gain bandwidth
enablers of dense::enablers of dense
dense wavelength division::dense wavelength division
kinds of fiber::kinds of fiber
doped fiber amplification::doped fiber amplification
number of excited::number of excited
meters of optical::meters of optical
optical fiber doped::optical fiber doped
million of erbium::million of erbium
erbium is pumped::erbium is pumped
laser to give::laser to give
amplify all lambdas::amplify all lambdas
simultaneously so key::simultaneously so key
key performance parameters::key performance parameters
performance parameters include::performance parameters include
parameters include saturation::parameters include saturation
include saturation output::include saturation output
saturation output power::saturation output power
input signal coming::input signal coming
coming through regular::coming through regular
pump some laser::pump some laser
kind of couplers::kind of couplers
talking about couplers::talking about couplers
ions become excited::ions become excited
incoming signal hits::incoming signal hits
emitting more photons::emitting more photons
signal is amplified::signal is amplified
kind of amplifier::kind of amplifier
amplifier called raman::amplifier called raman
lengths of fiber::lengths of fiber
basically using raman::basically using raman
kind of pump::kind of pump
pump and signal::pump and signal
signal this pump::signal this pump
due to raman::due to raman
amplified signal finally::amplified signal finally
kinds of dopants::kinds of dopants
praseodymium doped fluoride::praseodymium doped fluoride
doped fluoride fiber::doped fluoride fiber
thulium is considered::thulium is considered
tellerium erbium doped::tellerium erbium doped
erbium doped fibers::erbium doped fibers
range raman amplifiers::range raman amplifiers
raman amplifiers address::raman amplifiers address
address an extended::address an extended
spectrum using standard::spectrum using standard
standard single mode::standard single mode
thing about raman::thing about raman
edfas are popular::edfas are popular
popular in c-band::popular in c-band
raman are proposed::raman are proposed
proposed for s-band::proposed for s-band
gain shifted edfa::gain shifted edfa
edfa for l-band::edfa for l-band
kinds of doped::kinds of doped
component we talk::component we talk
sort of passive::sort of passive
coupler optical coupler::coupler optical coupler
optical coupler combines::optical coupler combines
combines and splits::combines and splits
splits signal wavelengths::splits signal wavelengths
signal wavelengths independent::signal wavelengths independent
independent or selective::independent or selective
selective ; fabricated::selective ; fabricated
fabricated using waveguides::fabricated using waveguides
waveguides in integrated::waveguides in integrated
integrated optics light::integrated optics light
optics light couples::optics light couples
closely placed waveguide::closely placed waveguide
propagation mode overlaps::propagation mode overlaps
input waveguide coming::input waveguide coming
splitting the signal::splitting the signal
power of input::power of input
power is split::power is split
so-called 3-db couplers::so-called 3-db couplers
couplers we put::couplers we put
half the power::half the power
power in input::power in input
power in output::power in output
two different destinations::two different destinations
iidentical waveguides complete::iidentical waveguides complete
waveguides complete coupling::waveguides complete coupling
couple mode theory::couple mode theory
follow the conservation::follow the conservation
conservation of energy::conservation of energy
out of phase::out of phase
phase and lossless::phase and lossless
sort of generalization::sort of generalization
recipient it divides::recipient it divides
divides the received::divides the received
ports at original::ports at original
stars can route::stars can route
route n simultaneous::route n simultaneous
splitter whatever signal::splitter whatever signal
signal is coming::signal is coming
divided into two::divided into two
couplers to form::couplers to form
splitter from y-couplers::splitter from y-couplers
simple modulation scheme::simple modulation scheme
types of modulation::types of modulation
direct modulation versus::direct modulation versus
modulation versus external::modulation versus external
versus external modulation::versus external modulation
modulation in modulation::modulation in modulation
ratio of output::ratio of output
power for bit::power for bit
problem another problem::problem another problem
problem with direct::problem with direct
generated whatever diode::generated whatever diode
naturally since direct::naturally since direct
modulation for higher::modulation for higher
longer distance dispersion::longer distance dispersion
prefer external modulation::prefer external modulation
modulation the light::modulation the light
continuously operated external::continuously operated external
operated external modulation::operated external modulation
external modulation turns::external modulation turns
modulation turns light::modulation turns light
turns light signal::turns light signal
package as laser::package as laser
modulator is external::modulator is external
packaged electro absorption::packaged electro absorption
kind of modulator::kind of modulator
applies an electric::applies an electric
shrinks the band::shrinks the band
gap and photons::gap and photons
photons are absorbed::photons are absorbed
set of components::set of components
components are multiplexers::components are multiplexers
wavelength selective devices::wavelength selective devices
wavelength filter suppose::wavelength filter suppose
wave band selection::wave band selection
band selection wave::band selection wave
selection wave bands::selection wave bands
side by side::side by side
select a band::select a band
bunch of frequencies::bunch of frequencies
wavelength band selection::wavelength band selection
band selection static::band selection static
selection static wavelength::selection static wavelength
static wavelength cross::static wavelength cross
wavelength cross connects::wavelength cross connects
connects and oadms::connects and oadms
optical add drop::optical add drop
add drop multiplexers::add drop multiplexers
context of sonet::context of sonet
domain we require::domain we require
require optical add::require optical add
equalization of gain::equalization of gain
application ; filtering::application ; filtering
filtering of noise::filtering of noise
noise ; ideas::noise ; ideas
operation and dispersion::operation and dispersion
dispersion compensation modules::dispersion compensation modules
standard wavelength selective::standard wavelength selective
wavelength selective components::wavelength selective components
components is arrayed::components is arrayed
arrayed waveguide gratings::arrayed waveguide gratings
selection of silica::selection of silica
acting as waveguides::acting as waveguides
waveguides each waveguide::waveguides each waveguide
length the incoming::length the incoming
signal is split::signal is split
running track bend::running track bend
track is longer::track is longer
sort of arrive::sort of arrive
output the incoming::output the incoming
wavelength then travels::wavelength then travels
delayed signals recombine::delayed signals recombine
recombine to give::recombine to give
give each wavelength::give each wavelength
reversed to act::reversed to act
demultiplexer ; usable::demultiplexer ; usable
usable in optical::usable in optical
optical integrated circuits::optical integrated circuits
demultiplexing one bunch::demultiplexing one bunch
frequencies are coming::frequencies are coming
colors of light::colors of light
light are coming::light are coming
direct opposite thing::direct opposite thing
multiplexer or demultiplexer::multiplexer or demultiplexer
bit about optical::bit about optical
remember electrical switching::remember electrical switching
input lines coming::input lines coming
coming in line::coming in line
out through line::out through line
operate the switch::operate the switch
line the basic::line the basic
simple switching element::simple switching element
wavelength is coming::wavelength is coming
wavelength conversion kind::wavelength conversion kind
kind of thing::kind of thing
optical plane redirecting::optical plane redirecting
plane redirecting light::plane redirecting light
operate at high::operate at high
advantages of doing::advantages of doing
advanced optical switching::advanced optical switching
optical switching technology::optical switching technology
technology is mems::technology is mems
tiny movable mirrors::tiny movable mirrors
mems optical cross::mems optical cross
optical cross connect::optical cross connect
follow the red::follow the red
mirrors to push::mirrors to push
adjusting the angles::adjusting the angles
simple and elegant::simple and elegant
kind of switch::kind of switch
switch the light::switch the light
couple of mirrors::couple of mirrors
fiber whatever signals::fiber whatever signals
carrying is immaterial::carrying is immaterial
sort of enables::sort of enables
frequency division multiplexing::frequency division multiplexing
opposite of optical::opposite of optical
domain in wavelength::domain in wavelength
property for wavelength::property for wavelength
multiplexing for achieving::multiplexing for achieving
achieving very high::achieving very high
high data rates::high data rates
kinds of wavelength::kinds of wavelength
people use dwdm::people use dwdm
dwdm dwdm means::dwdm dwdm means
dwdm means dense::dwdm means dense
means dense wavelength::means dense wavelength
multiplexing by dense::multiplexing by dense
put a lot::put a lot
lot of channels::lot of channels
lan because dwdm::lan because dwdm
dwdm is costly::dwdm is costly
speed that cost::speed that cost
cost is effective::cost is effective
kind of wavelength::kind of wavelength
multiplexing is coming::multiplexing is coming
coming into lans::coming into lans
cwdm or coarse::cwdm or coarse
coarse wavelength division::coarse wavelength division
issue so cdwm::issue so cdwm
cheaper than dwdm::cheaper than dwdm
dwdm and cwdm::dwdm and cwdm
cwdm is coming::cwdm is coming
details of wavelength::details of wavelength
increases the capacity::increases the capacity
capacity of optical::capacity of optical
fiber ; multiplexing::fiber ; multiplexing
multiplexing is combining::multiplexing is combining
wavelengths ; demultiplexing::wavelengths ; demultiplexing
demultiplexing is splitting::demultiplexing is splitting
splitting of wavelengths::splitting of wavelengths
number of wavelengths::number of wavelengths
people are talking::people are talking
talking about hundreds::talking about hundreds
hundreds of wavelengths::hundreds of wavelengths
wavelengths are separated::wavelengths are separated
separated by multiples::separated by multiples
itu standard coarse::itu standard coarse
standard coarse wdm::standard coarse wdm
widely separated wavelengths::widely separated wavelengths
end the multiplexer::end the multiplexer
point-to-point wdm system::point-to-point wdm system
point is connected::point is connected
point through multiple::point through multiple
multiple wavelengths wdm::multiple wavelengths wdm
technology in point-to-point::technology in point-to-point
kms in shorter::kms in shorter
fiber is cheaper::fiber is cheaper
naturally your end::naturally your end
strands of fiber::strands of fiber
wavelength add drop::wavelength add drop
add drop multiplexer::add drop multiplexer
thing we require::thing we require
stream of wdm::stream of wdm
drop multiplexer needed::drop multiplexer needed
needed for routing::needed for routing
routing and wavelength::routing and wavelength
assignment it performs::assignment it performs
level of wavelengths::level of wavelengths
counterparts like adm::counterparts like adm
adm in sonet::adm in sonet
domain one problem::domain one problem
granularity is high::granularity is high
capacity of wavelengths::capacity of wavelengths
out one single::out one single
bunch of wavelengths::bunch of wavelengths
wavelength can carry::wavelength can carry
carry a large::carry a large
amount of traffic::amount of traffic
amounts of traffic::amounts of traffic
add or drop::add or drop
wadm has multiplexers::wadm has multiplexers
electronically to control::electronically to control
control which incoming::control which incoming
incoming length flows::incoming length flows
fiber and wavelength::fiber and wavelength
connects are important::connects are important
needed in real::needed in real
real networks point-to-point::real networks point-to-point
networks point-to-point connection::networks point-to-point connection
router or active::router or active
entire communication network::entire communication network
separately each wavelength::separately each wavelength
carry multiple connections::carry multiple connections
coming from fiber::coming from fiber
out through fiber::out through fiber
route n2 simultaneous::route n2 simultaneous
discuss the routing::discuss the routing
active routing matrix::active routing matrix
conclude our initial::conclude our initial
discuss the details::discuss the details
details of wdm::details of wdm
wavelengths are routed::wavelengths are routed
entire network output::entire network output
lecture computer networks::lecture computer networks
computer networks prof::computer networks prof
networks prof sujoy::networks prof sujoy
prof sujoy ghosh::prof sujoy ghosh
sujoy ghosh dept::sujoy ghosh dept
dept of computer::dept of computer
computer science& engineering::computer science& engineering
science& engineering iit::science& engineering iit
engineering iit kharagpur::engineering iit kharagpur
iit kharagpur lecture::iit kharagpur lecture
assignment in wdm::assignment in wdm
wdm all optical::wdm all optical
iin this lecture::iin this lecture
continue our discussion::continue our discussion
deviation and multiplexing::deviation and multiplexing
talk about routing::talk about routing
rrouting and wavelength::rrouting and wavelength
wavelength assignment means::wavelength assignment means
stream of packets::stream of packets
destination now tthese::destination now tthese
sources and destination::sources and destination
point to point::point to point
directly connected general::directly connected general
connected general tthey::connected general tthey
notes to reach::notes to reach
reach the destination::reach the destination
llet us assume::llet us assume
assign one wave::assign one wave
problem of routing::problem of routing
series of lectures::series of lectures
lectures but routing::lectures but routing
kinds of routing::kinds of routing
problem here sso::problem here sso
routing and wave::routing and wave
wave length assignment::wave length assignment
light path establishment::light path establishment
iin the first::iin the first
suppose this dashed::suppose this dashed
lambda one lambda::lambda one lambda
sso the lambed::sso the lambed
switched to lambda::switched to lambda
lambda one lamda::lambda one lamda
wwe have light::wwe have light
light a paths::light a paths
fibers the lambda::fibers the lambda
lambda ones lamda::lambda ones lamda
inorder to connect::inorder to connect
lambda two lamda::lambda two lamda
connects me higher::connects me higher
connect will connect::connect will connect
fiber so wwe::fiber so wwe
long and variable::long and variable
variable length payload::variable length payload
long low amortized::long low amortized
low amortized overhead::low amortized overhead
overhead no fragmentation::overhead no fragmentation
fragmentation aa control::fragmentation aa control
out of band::out of band
band that means::band that means
lambda lambda lamda::lambda lambda lamda
lambda lamda control::lambda lamda control
control and reserves::control and reserves
lambda lamda data::lambda lamda data
lamda data reserves::lamda data reserves
path and configures::path and configures
configures the switches::configures the switches
setting up temporary::setting up temporary
temporary light path::temporary light path
sso no buffering::sso no buffering
buffering is needed::buffering is needed
optical buffer sso::optical buffer sso
buffer sso buffers::buffer sso buffers
simply simply passes::simply simply passes
optical domain sso::optical domain sso
nice so offset::nice so offset
delta ? amount::delta ? amount
optical switch fabric::optical switch fabric
offset is exhausted::offset is exhausted
computer networks::computer networks
sujoy ghosh::sujoy ghosh
ghosh department::ghosh department
computer science::computer science
engineering iit::engineering iit
kharagpur lecture::kharagpur lecture
good day::good day
optic communication::optic communication
heard tthis::heard tthis
tthis lecture::tthis lecture
optic components::optic components
layer components::layer components
optic systems::optic systems
wdm systems::wdm systems
wavelength division::wavelength division
division multiplexing::division multiplexing
optic domain::optic domain
fifty percent::fifty percent
fiber optics::fiber optics
components today::components today
optic component::optic component
basic fiber::basic fiber
light sources::light sources
optical fiber::optical fiber
transparent silica::transparent silica
silica glass::silica glass
moderate dimension::moderate dimension
total internal::total internal
internal reflection::internal reflection
ordinary light::ordinary light
multimode fiber::multimode fiber
mmf mmf::mmf mmf
lans lans::lans lans
low speeds::low speeds
short distances::short distances
cheaper variety::cheaper variety
lan lans::lan lans
low speed::low speed
speed wwhen::speed wwhen
hundred mbps::hundred mbps
smaller dimension::smaller dimension
physical layer::physical layer
cross section::cross section
thin strand::thin strand
glass fiber::glass fiber
fiber tthis::fiber tthis
actual part::actual part
outer protection::outer protection
nanometer range::nanometer range
wave guide::wave guide
single mode::single mode
eelectro mmagnetics::eelectro mmagnetics
guide propagation::guide propagation
mode fiber::mode fiber
fiber smf::fiber smf
higher speed::higher speed
longer distance::longer distance
mode fibers::mode fibers
transmission windows::transmission windows
fifty nanometer::fifty nanometer
haul applications::haul applications
wider window::wider window
good optical::good optical
optical amplifiers::optical amplifiers
fifty nanometer1550::fifty nanometer1550
low attenuation::low attenuation
ssimilarly,thirteen ten::ssimilarly,thirteen ten
actual practice::actual practice
main thing::main thing
previous diagram::previous diagram
loses energy::loses energy
lower magnitude::lower magnitude
lower strength::lower strength
light signal::light signal
longer distances::longer distances
rayleigh scattering::rayleigh scattering
refractive index::refractive index
mie scattering::mie scattering
cylindrical structure::cylindrical structure
rigorous specification::rigorous specification
engineering world::engineering world
signal strength::signal strength
digital waveform::digital waveform
square waveform::square waveform
spectral component::spectral component
fuller transformation::fuller transformation
wave shape::wave shape
perfect square::perfect square
square shape::square shape
specific strengths::specific strengths
strengths compared::strengths compared
differential losses::differential losses
pulse shape::pulse shape
chromatic dispersion::chromatic dispersion
spectral components::spectral components
pulse travel::pulse travel
group velocity::group velocity
velocity dispersion::velocity dispersion
chromatic pulse::chromatic pulse
input pulse::input pulse
output pulse::output pulse
flattened shape::flattened shape
special types::special types
reduced dispersion::reduced dispersion
dispersion fiber::dispersion fiber
dispersion shifted::dispersion shifted
shifted fibers::shifted fibers
natural dispersion::natural dispersion
nonzero dispersion::nonzero dispersion
normal smf::normal smf
deployed plant::deployed plant
plant dispersion::plant dispersion
nanometer kilometer::nanometer kilometer
interesting areas::interesting areas
special fiber::special fiber
long haul::long haul
short haul::short haul
shifted characteristics::shifted characteristics
ordinary fiber::ordinary fiber
small distance::small distance
bandwidth span::bandwidth span
span product::span product
transmission lines::transmission lines
transmission line::transmission line
data rate::data rate
rate constant::rate constant
bandwidth distance::bandwidth distance
distance product::distance product
older kind::older kind
high speed::high speed
typical figures::typical figures
exact figures::exact figures
ideas sso::ideas sso
forty kilometers640::forty kilometers640
kilometers640 kms::kilometers640 kms
decent smf::decent smf
giga bits::giga bits
ten giga::ten giga
dwdm dwdm::dwdm dwdm
large number::large number
tremendous data::tremendous data
high data::high data
major advantage::major advantage
electromagnetic radiations::electromagnetic radiations
good thing::good thing
things moving::things moving
noisy electromagnetic::noisy electromagnetic
electromagnetic ambience::electromagnetic ambience
good point::good point
light source::light source
led light::led light
multi mode::multi mode
forward biased::forward biased
biased pn-junction::biased pn-junction
injected minority::injected minority
minority carriers::minority carriers
spontaneous emission::spontaneous emission
emission produces::emission produces
broad spectrum::broad spectrum
gain bandwidth::gain bandwidth
low power::low power
continuous source::continuous source
low internal::low internal
internal modulation::internal modulation
wide area::wide area
area network::area network
multimode fibers::multimode fibers
leds led::leds led
filter iit::filter iit
power loss::power loss
semiconductor lasers::semiconductor lasers
higher power::higher power
power output::power output
short duration::short duration
intense pulses::intense pulses
high power::high power
sharp spectrum::sharp spectrum
wide range::wide range
larger bit::larger bit
bit rates::bit rates
rates compared::rates compared
mlm mnf::mlm mnf
special kind::special kind
tunable lasers::tunable lasers
lasers means::lasers means
tunable laser::tunable laser
frequency emitted::frequency emitted
lasing system::lasing system
continuous range::continuous range
hundred nanometer::hundred nanometer
long lifetime::long lifetime
good points::good points
electromagnetic field::electromagnetic field
field sso::field sso
temperature tuning::temperature tuning
mechanical tuning::mechanical tuning
mems mems::mems mems
discuss wdm::discuss wdm
wdm wdm::wdm wdm
light pulse::light pulse
pulse coming::pulse coming
conduction band::conduction band
band sso::band sso
standard photo::standard photo
photo detector::photo detector
energy gap::energy gap
easiest thing::easiest thing
fibers running::fibers running
kilometers sso::kilometers sso
haul fibers::haul fibers
nnowadays twenty::nnowadays twenty
special cases::special cases
optical signals::optical signals
signals traveling::signals traveling
long distance::long distance
olt olt::olt olt
older technology::older technology
optical signal::optical signal
electronic domain::electronic domain
optical domain::optical domain
main disadvantage::main disadvantage
means cost::means cost
erbium doped::erbium doped
doped fiber::doped fiber
fiber amplifiers::fiber amplifiers
light propagating::light propagating
signal level::signal level
minimum operating::minimum operating
operating level::operating level
simple amplification::simple amplification
require regeneration::require regeneration
so-called 3rs::so-called 3rs
means increase::means increase
absorption loss::absorption loss
long distances::long distances
tremendous amount::tremendous amount
special kinds::special kinds
deployed today::deployed today
right square::right square
clocks synchronized::clocks synchronized
tdm signals::tdm signals
strict control::strict control
input shape::input shape
shaped pulse::shaped pulse
high-speed electronics::high-speed electronics
schemes today::schemes today
optical waves::optical waves
opposite direction::opposite direction
standard fiber::standard fiber
deployed system::deployed system
specific bit::specific bit
bit rate::bit rate
opaque unit::opaque unit
modulation format::modulation format
simply amplifying::simply amplifying
higher bit::higher bit
service providers::service providers
large gain::large gain
key enablers::key enablers
dense wavelength::dense wavelength
standard kinds::standard kinds
fiber amplification::fiber amplification
earlier erbium::earlier erbium
excited states::excited states
fiber doped::fiber doped
give amplification::give amplification
window simultaneously::window simultaneously
key performance::key performance
performance parameters::performance parameters
parameters include::parameters include
include saturation::include saturation
saturation output::saturation output
output power::output power
noise figure::noise figure
gain flatness::gain flatness
pass band::pass band
signal coming::signal coming
regular fiber::regular fiber
pumping laser::pumping laser
erbium ions::erbium ions
incoming signal::incoming signal
signal hits::signal hits
ground state::ground state
raman amplifier::raman amplifier
longer lengths::longer lengths
raman scattering::raman scattering
atoms excited::atoms excited
signal finally::signal finally
praseodymium doped::praseodymium doped
doped fluoride::doped fluoride
fluoride fiber::fluoride fiber
thorium doped::thorium doped
thulium doped::thulium doped
rare material::rare material
tellerium erbium::tellerium erbium
doped fibers::doped fibers
range raman::range raman
raman amplifiers::raman amplifiers
amplifiers address::amplifiers address
extended spectrum::extended spectrum
standard single::standard single
gain shifted::gain shifted
shifted edfa::shifted edfa
raman amplification::raman amplification
entire range::entire range
first component::first component
passive device::passive device
optical coupler::optical coupler
coupler combines::coupler combines
signal wavelengths::signal wavelengths
wavelength independent::wavelength independent
integrated optics::integrated optics
optics light::optics light
light couples::light couples
propagation mode::propagation mode
mode overlaps::mode overlaps
input waveguide::input waveguide
waveguide coming::waveguide coming
signals joining::signals joining
edfa amplifier::edfa amplifier
coupling ratio::coupling ratio
times power::times power
input power::input power
iidentical waveguides::iidentical waveguides
complete coupling::complete coupling
back periodically::back periodically
couple mode::couple mode
mode theory::mode theory
energy constraint::energy constraint
electric fields::electric fields
lossless combining::lossless combining
passive star::passive star
broadcast device::broadcast device
output ports::output ports
original wavelength::original wavelength
received strength::received strength
weak signal::weak signal
passive stars::passive stars
simultaneous connections::simultaneous connections
eight-port splitter::eight-port splitter
port splitter::port splitter
star coupler::star coupler
optical modulation::optical modulation
simple modulation::simple modulation
modulation scheme::modulation scheme
digital systems::digital systems
modulation techniques::modulation techniques
direct modulation::direct modulation
modulation versus::modulation versus
external modulation::external modulation
extinction ratio::extinction ratio
indirect modulation::indirect modulation
higher speeds::higher speeds
distance dispersion::distance dispersion
limited regimes::limited regimes
continuously operated::continuously operated
modulation turns::modulation turns
laser source::laser source
packaged electro::packaged electro
electro absorption::electro absorption
important kind::important kind
electric field::electric field
band gap::band gap
selective devices::selective devices
wavelength filter::wavelength filter
filter suppose::filter suppose
wavelength multiplexer::wavelength multiplexer
wave band::wave band
band selection::band selection
selection wave::selection wave
wave bands::wave bands
operating wavelengths::operating wavelengths
operating window::operating window
guard band::guard band
wavelength band::wavelength band
static wavelength::static wavelength
wavelength cross::wavelength cross
cross connects::cross connects
oadms oadms::oadms oadms
optical add::optical add
add drop::add drop
drop multiplexers::drop multiplexers
laser operation::laser operation
dispersion compensation::dispersion compensation
compensation modules::compensation modules
standard wavelength::standard wavelength
selective components::selective components
arrayed waveguide::arrayed waveguide
waveguide gratings::waveguide gratings
curved selection::curved selection
silica acting::silica acting
running track::running track
track bend::track bend
outer track::outer track
athletic event::athletic event
proper handicap::proper handicap
delayed signals::delayed signals
signals recombine::signals recombine
integrated circuits::integrated circuits
separated out::separated out
demultiplexing action::demultiplexing action
direct opposite::direct opposite
opposite thing::opposite thing
awb acting::awb acting
optical switches::optical switches
electrical switches::electrical switches
optical switching::optical switching
remember electrical::remember electrical
electrical switching::electrical switching
input lines::input lines
lines coming::lines coming
basic idea::basic idea
output line::output line
simple switching::simple switching
switching element::switching element
input port::input port
wavelength conversion::wavelength conversion
conversion kind::conversion kind
optical plane::optical plane
plane redirecting::plane redirecting
electrical conversion::electrical conversion
high speeds::high speeds
underlying protocol::underlying protocol
higher layer::higher layer
advanced optical::advanced optical
switching technology::switching technology
tiny movable::tiny movable
movable mirrors::movable mirrors
crossbar switch::crossbar switch
optical cross::optical cross
cross connect::cross connect
tiny mirrors::tiny mirrors
red line::red line
line number::line number
mems technology::mems technology
elegant kind::elegant kind
technology sort::technology sort
wdm technology::wdm technology
discussing multiplexing::discussing multiplexing
frequency division::frequency division
white light::white light
frequencies split::frequencies split
data rates::data rates
people talk::people talk
dwdm means::dwdm means
means dense::means dense
coarse wavelength::coarse wavelength
laser sources::laser sources
wdm increases::wdm increases
optical fibers::optical fibers
wavelength lasers::wavelength lasers
combining wavelengths::combining wavelengths
thousands wavelengths::thousands wavelengths
ghz separation::ghz separation
minimum separation::minimum separation
itu standard::itu standard
standard coarse::standard coarse
coarse wdm::coarse wdm
separated wavelengths::separated wavelengths
wdm system::wdm system
lights coming::lights coming
point-to-point wdm::point-to-point wdm
multiple wavelengths::multiple wavelengths
wavelengths wdm::wavelengths wdm
cost-effective technology::cost-effective technology
point-to-point technology::point-to-point technology
shorter distances::shorter distances
multi fiber::multi fiber
end equipment::end equipment
extra strands::extra strands
cheaper option::cheaper option
wavelength add::wavelength add
drop multiplexer::drop multiplexer
extra wavelengths::extra wavelengths
multiplexer needed::multiplexer needed
wavelength assignment::wavelength assignment
electronic counterpart::electronic counterpart
electronic counterparts::electronic counterparts
inherent capacity::inherent capacity
single wavelength::single wavelength
large amount::large amount
high amount::high amount
small amounts::small amounts
effective technology::effective technology
incoming length::incoming length
length flows::length flows
important components::important components
real networks::real networks
point-to-point connection::point-to-point connection
passive router::passive router
active switch::active switch
entire communication::entire communication
communication network::communication network
wavelength reuse::wavelength reuse
carry multiple::carry multiple
multiple connections::multiple connections
wavelength coming::wavelength coming
routing issues::routing issues
active routing::active routing
routing matrix::routing matrix
initial portion::initial portion
entire network::entire network
network output::network output
lecture computer::lecture computer
networks prof::networks prof
prof sujoy::prof sujoy
ghosh dept::ghosh dept
computer science&::computer science&
science& engineering::science& engineering
iit kharagpur::iit kharagpur
optical networks::optical networks
wavelength deviation::wavelength deviation
assignment means::assignment means
tthese sources::tthese sources
point connection::point connection
directly connected::directly connected
general tthey::general tthey
intermediate notes::intermediate notes
destination sso::destination sso
wavelength sso::wavelength sso
wave length::wave length
simple kinds::simple kinds
routing problem::routing problem
length assignment::length assignment
light path::light path
path establishment::path establishment
first part::first part
left half::left half
physical connection::physical connection
dashed line::dashed line
lambed lambda1::lambed lambda1
outgoing fiber::outgoing fiber
paths established::paths established
outgoing fibers::outgoing fibers
lambda lamda::lambda lamda
variable length::variable length
length payload::length payload
control packet::control packet
lambda lambda::lambda lambda
lamda control::lamda control
reserves bandwidth::reserves bandwidth
lamda data::lamda data
data reserves::data reserves
switches sso::switches sso
temporary light::temporary light
original problem::original problem
optical buffer::optical buffer
buffer sso::buffer sso
sso buffers::sso buffers
burst arrives::burst arrives
intermediate node::intermediate node
domain sso::domain sso
minus delta::minus delta
spent delta::spent delta
optical switch::optical switch
intervening notes::intervening notes
computer::computer
networks::networks
prof::prof
sujoy::sujoy
ghosh::ghosh
department::department
science::science
engineering::engineering
iit::iit
kharagpur::kharagpur
lecture::lecture
start::start
good::good
day::day
ttoday::ttoday
speaking::speaking
noise::noise
fiber::fiber
optic::optic
components::components
min::min
communication::communication
heard::heard
tthis::tthis
couple::couple
lectures::lectures
concentrate::concentrate
looked::looked
physical::physical
layer::layer
systems::systems
quickly::quickly
review::review
ssome::ssome
stuff::stuff
talking::talking
today::today
common::common
point::point
out::out
wdm::wdm
details::details
wavelength::wavelength
division::division
multiplexing::multiplexing
done::done
handled::handled
domain::domain
tthe::tthe
crucial::crucial
lot::lot
traffic::traffic
terms::terms
volume::volume
okmay::okmay
forty::forty
fifty::fifty
percent::percent
days::days
demand::demand
bandwidth::bandwidth
coming::coming
optics::optics
important::important
noisesso::noisesso
sso::sso
component::component
basic::basic
talked::talked
talk::talk
bit::bit
light::light
sources::sources
receivers::receivers
twotwo::twotwo
ends::ends
cables::cables
carrier::carrier
information::information
require::require
amplifiers::amplifiers
couplers::couplers
modulators::modulators
multiplexers::multiplexers
switches::switches
tthen::tthen
discussion::discussion
optical::optical
mentioned::mentioned
earlier::earlier
pure::pure
transparent::transparent
silica::silica
glass::glass
aat::aat
moderate::moderate
dimension::dimension
restricted::restricted
total::total
internal::internal
reflection::reflection
ordinary::ordinary
multimode::multimode
mmf::mmf
lans::lans
low::low
speeds::speeds
short::short
distances::distances
kind::kind
bbut::bbut
cheaper::cheaper
variety::variety
lan::lan
speed::speed
wwhen::wwhen
comparatively::comparatively
hundred::hundred
mbps::mbps
kilometers::kilometers
maximum::maximum
smaller::smaller
part::part
carries::carries
signal::signal
remember::remember
fibers::fibers
shown::shown
diagrams::diagrams
cross::cross
section::section
core::core
thin::thin
strand::strand
surrounded::surrounded
cladding::cladding
made::made
actual::actual
carrying::carrying
surrounding::surrounding
coated::coated
covered::covered
outer::outer
protection::protection
nanometer::nanometer
range::range
acts::acts
wave::wave
guide::guide
single::single
mode::mode
operations::operations
wwe::wwe
eelectro::eelectro
mmagnetics::mmagnetics
propagation::propagation
ways::ways
support::support
smf::smf
higher::higher
longer::longer
distance::distance
nowadays::nowadays
span::span
oceans::oceans
continent::continent
marvel::marvel
technology::technology
transmission::transmission
windows::windows
fifteen::fifteen
window::window
preferred::preferred
long::long
haul::haul
applications::applications
attenuation::attenuation
wider::wider
easily::easily
t,this::t,this
diagram::diagram
nanometer1550::nanometer1550
ssimilarly,thirteen::ssimilarly,thirteen
ten::ten
nanometeris::nanometeris
wide::wide
practice::practice
back::back
discuss::discuss
losses::losses
fiber,losses::fiber,losses
due::due
reasons::reasons
main::main
thing::thing
absorption::absorption
showed::showed
previous::previous
loses::loses
energy::energy
atom::atom
absorbs::absorbs
photons::photons
lower::lower
magnitude::magnitude
strength::strength
scattering::scattering
medium::medium
rayleigh::rayleigh
slight::slight
refractive::refractive
index::index
mie::mie
imperfection::imperfection
cylindrical::cylindrical
structure::structure
rigorous::rigorous
specification::specification
exact::exact
world::world
types::types
leading::leading
lowering::lowering
problem::problem
nonuniform::nonuniform
wavelengths::wavelengths
means::means
loss::loss
frequency::frequency
trouble::trouble
waveform::waveform
specially::specially
digital::digital
square::square
analyse::analyse
spectral::spectral
iif::iif
fuller::fuller
transformation::transformation
harmonics::harmonics
shape::shape
perfect::perfect
specific::specific
strengths::strengths
compared::compared
ddue::ddue
differential::differential
frequencies::frequencies
happen::happen
balance::balance
disturbed::disturbed
pulse::pulse
changed::changed
chromatic::chromatic
dispersion::dispersion
depends::depends
color::color
travel::travel
velocities::velocities
group::group
velocity::velocity
leads::leads
input::input
output::output
flattened::flattened
attenuated::attenuated
differently::differently
compensating::compensating
dispersions::dispersions
special::special
reduced::reduced
shifted::shifted
natural::natural
sort::sort
acted::acted
nonzero::nonzero
normal::normal
places::places
ninety::ninety
percent95::percent95
deployed::deployed
plant::plant
measured::measured
pico::pico
kilometer::kilometer
interesting::interesting
areas::areas
utilized::utilized
bother::bother
characteristics::characteristics
small::small
matter::matter
product::product
kinds::kinds
lines::lines
line::line
operates::operates
operate::operate
increase::increase
rate::rate
pumping::pumping
data::data
constant::constant
length::length
work::work
lets::lets
double::double
older::older
high::high
typical::typical
figures::figures
ideas::ideas
two::two
giga::giga
kilometers640::kilometers640
kms::kms
amplification::amplification
decent::decent
bits::bits
four::four
thousand::thousand
kms,ok::kms,ok
spans::spans
multiply::multiply
dwdm::dwdm
presently::presently
large::large
number::number
channels::channels
realize::realize
tremendous::tremendous
major::major
advantage::advantage
tthere::tthere
advantages::advantages
susceptible::susceptible
electromagnetic::electromagnetic
radiations::radiations
gadgets::gadgets
things::things
moving::moving
noisy::noisy
ambience::ambience
immune::immune
ime::ime
source::source
led::led
depending::depending
multi::multi
cheap::cheap
scale::scale
forward::forward
biased::biased
pn-junction::pn-junction
recombination::recombination
injected::injected
minority::minority
carriers::carriers
spontaneous::spontaneous
emission::emission
produces::produces
broad::broad
spectrum::spectrum
gain::gain
power::power
divide::divide
continuous::continuous
twenty::twenty
dbm::dbm
modulation::modulation
modulate::modulate
internally::internally
hundreds::hundreds
mega::mega
again::again,
area::area
network::network
leds::leds
slicing::slicing
filter::filter
moment::moment
laser::laser
semiconductor::semiconductor
lasers::lasers
duration::duration
intense::intense
pulses::pulses
sharp::sharp
coherent::coherent
property::property
reduces::reduces
modulated::modulated
externally::externally
larger::larger
rates::rates
mlm::mlm
mnf::mnf
devices::devices
tunable::tunable
change::change
cases::cases
tuning::tuning
fairly::fairly
rapid::rapid
sense::sense
milliseconds::milliseconds
order::order
emitted::emitted
lasing::lasing
system::system
lifetime::lifetime
stable::stable
controllable::controllable
manufacturable::manufacturable
points::points
methods::methods
changing::changing
injecting::injecting
current::current
applying::applying
field::field
temperature::temperature
first::first
narrow::narrow
degrade::degrade
mechanical::mechanical
mems::mems
compact::compact
costly::costly
slightly::slightly
complex::complex
manage::manage
instances::instances
mention::mention
detected::detected
photon::photon
push::push
electron::electron
conduction::conduction
band::band
standard::standard
photo::photo
detector::detector
studied::studied
school::school
gap::gap
naturally::naturally
show::show
conducting::conducting
easiest::easiest
mentioning::mentioning
running::running
thousands::thousands
weak::weak
amplify::amplify
previously::previously
5kms::5kms
nnowadays::nnowadays
signals::signals
traveling::traveling
strengthened::strengthened
olt::olt
converted::converted
electronic::electronic
disadvantages::disadvantages
disadvantage::disadvantage
cost::cost
idea::idea
erbium::erbium
doped::doped
dopers::dopers
scenario::scenario
propagating::propagating
propagates::propagates
level::level
minimum::minimum
operating::operating
amplifier::amplifier
decay::decay
repeaters::repeaters
simple::simple
regeneration::regeneration
so-called::so-called
3rs::3rs
reamplify::reamplify
reshape::reshape
retime::retime
concerned::concerned
simply::simply
size::size
distorted::distorted
side::side
amount::amount
errors::errors
acceptable::acceptable
commonly::commonly
bring::bring
give::give
right::right
timing::timing
clocks::clocks
synchronized::synchronized
tdm::tdm
strict::strict
control::control
edfa::edfa
reshaping::reshaping
suppose::suppose
properly::properly
nicely::nicely
shaped::shaped
reshaped::reshaped
face::face
case::case
inherently::inherently
high-speed::high-speed
electronics::electronics
difficult::difficult
schemes::schemes
handling::handling
waves::waves
solitons::solitons
mixed::mixed
manner::manner
cancel::cancel
similarly::similarly
opposite::opposite
direction::direction
brought::brought
atoms::atoms
handle::handle
widely::widely
regenerators::regenerators
opaque::opaque
unit::unit
format::format
amplified::amplified
protocol::protocol
amplifying::amplifying
upgraded::upgraded
replacing::replacing
infrastructure::infrastructure
service::service
providers::providers
taking::taking
replace::replace
key::key
enablers::enablers
dense::dense
excited::excited
states::states
meters::meters
parts::parts
million::million
pumped::pumped
edfas::edfas
lambdas::lambdas
simultaneously::simultaneously
performance::performance
parameters::parameters
include::include
saturation::saturation
figure::figure
flatness::flatness
pass::pass
regular::regular
pump::pump
combined::combined
ions::ions
incoming::incoming
hits::hits
fall::fall
ground::ground
state::state
emitting::emitting
raman::raman
lengths::lengths
basically::basically
counter::counter
finally::finally
dopants::dopants
praseodymium::praseodymium
fluoride::fluoride
pdffa::pdffa
thorium::thorium
thulium::thulium
academic::academic
considered::considered
rare::rare
material::material
tellerium::tellerium
address::address
extended::extended
popular::popular
c-band::c-band
proposed::proposed
s-band::s-band
l-band::l-band
relevant::relevant
tdfa::tdfa
pdfa::pdfa
entire::entire
passive::passive
device::device
coupler::coupler
combines::combines
splits::splits
independent::independent
selective::selective
fabricated::fabricated
waveguides::waveguides
integrated::integrated
couples::couples
waveguide::waveguide
closely::closely
overlaps::overlaps
picture::picture
outputs::outputs
joining::joining
wanted::wanted
put::put
splitting::splitting
split::split
directions::directions
coupling::coupling
ratio::ratio
times::times
3-db::3-db
half::half
broadcast::broadcast
destinations::destinations
3db::3db
iidentical::iidentical
complete::complete
periodically::periodically
theory::theory
follow::follow
conservation::conservation
constraint::constraint
electric::electric
fields::fields
phase::phase
lossless::lossless
combining::combining
efficient::efficient
star::star
generalization::generalization
recipient::recipient
divides::divides
received::received
ports::ports
original::original
proportionally::proportionally
application::application
stars::stars
route::route
simultaneous::simultaneous
connections::connections
eight-port::eight-port
splitter::splitter
divided::divided
form::form
port::port
y-couplers::y-couplers
communicate::communicate
broadcasting::broadcasting
scheme::scheme
keying::keying
techniques::techniques
direct::direct
versus::versus
external::external
extinction::extinction
directly::directly
modulating::modulating
place::place
generated::generated
diode::diode
generating::generating
indirect::indirect
making::making
solution::solution
chirp::chirp
limited::limited
regimes::regimes
prefer::prefer
continuously::continuously
operated::operated
turns::turns
package::package
modulator::modulator
packaged::packaged
electro::electro
applies::applies
shrinks::shrinks
absorbed::absorbed
transmit::transmit
set::set
filters::filters
gratings::gratings
multiplexer::multiplexer
selection::selection
bands::bands
contiguous::contiguous
guard::guard
iqt::iqt
grouped::grouped
select::select
bunch::bunch
selecting::selecting
static::static
connects::connects
oadms::oadms
add::add
drop::drop
term::term
context::context
sonet::sonet
equalization::equalization
filtering::filtering
operation::operation
compensation::compensation
modules::modules
arrayed::arrayed
curved::curved
acting::acting
track::track
bend::bend
athletic::athletic
event::event
race::race
athletes::athletes
proper::proper
handicap::handicap
make::make
deliberately::deliberately
arrive::arrive
travels::travels
delayed::delayed
recombine::recombine
reversed::reversed
act::act
demultiplexer::demultiplexer
usable::usable
circuits::circuits
functions::functions
doing::doing
demultiplexing::demultiplexing
colors::colors
separated::separated
action::action
awb::awb
electrical::electrical
switching::switching
switch::switch
connect::connect
element::element
conversion::conversion
plane::plane
redirecting::redirecting
harping::harping
upgrade::upgrade
eventually::eventually
depend::depend
underlying::underlying
advanced::advanced
tiny::tiny
movable::movable
mirrors::mirrors
crossbar::crossbar
red::red
adjusting::adjusting
angles::angles
elegant::elegant
bumps::bumps
immaterial::immaterial
enables::enables
discussing::discussing
mix::mix
end::end
sunlight::sunlight
white::white
send::send
prism::prism
achieving::achieving
people::people
backbone::backbone
effective::effective
cwdm::cwdm
coarse::coarse
packed::packed
sparsely::sparsely
stability::stability
detectors::detectors
issue::issue
cdwm::cdwm
continue::continue
increases::increases
capacity::capacity
big::big
multiples::multiples
equivalent::equivalent
ghz::ghz
separation::separation
mandated::mandated
itu::itu
sophisticated::sophisticated
lights::lights
flowing::flowing
demultiplexed::demultiplexed
awg::awg
point-to-point::point-to-point
connected::connected
multiple::multiple
cost-effective::cost-effective
greater::greater
shorter::shorter
equipment::equipment
extra::extra
strands::strands
option::option
stream::stream
needed::needed
routing::routing
assignment::assignment
performs::performs
counterpart::counterpart
counterparts::counterparts
adm::adm
granularity::granularity
inherent::inherent
carry::carry
gbps::gbps
amounts::amounts
wadm::wadm
managed::managed
electronically::electronically
programmed::programmed
flows::flows
dropped::dropped
real::real
connection::connection
router::router
active::active
discussed::discussed
separately::separately
reuse::reuse
perfectly::perfectly
issues::issues
features::features
difference::difference
matrix::matrix
functionality::functionality
powered::powered
conclude::conclude
initial::initial
portion::portion
routed::routed
preview::preview
dept::dept
science&::science&
iin::iin
deviation::deviation
specifically::specifically
09-54::09-54
rrouting::rrouting
packets::packets
destination::destination
tthese::tthese
sends::sends
general::general
tthey::tthey
intermediate::intermediate
notes::notes
reach::reach
llet::llet
assume::assume
continued::continued
assign::assign
easier::easier
series::series
43-56::43-56
path::path
establishment::establishment
abcde::abcde
left::left
links::links
established::established
dashed::dashed
lambda::lambda
lambed::lambed
lambda1::lambda1
switched::switched
lamda::lamda
outgoing::outgoing
paths::paths
inorder::inorder
ssimilarly::ssimilarly
55-57::55-57
burst::burst
variable::variable
payload::payload
amortized::amortized
overhead::overhead
fragmentation::fragmentation
packet::packet
reserves::reserves
configures::configures
setting::setting
temporary::temporary
offset::offset
arrives::arrives
configured::configured
buffering::buffering
buffer::buffer
buffers::buffers
avoided::avoided
fashion::fashion
42-58::42-58
node::node
configuration::configuration
delay::delay
calculated::calculated
fabric::fabric
store::store
passes::passes
21-58::21-58
nice::nice
minus::minus
delta::delta
spent::spent
intervening::intervening
exhausted::exhausted
reached::reached
