computer networks prof::computer networks prof
networks prof sujoy::networks prof sujoy
prof sujoy ghosh::prof sujoy ghosh
sujoy ghosh iit::sujoy ghosh iit
ghosh iit kharagpur::ghosh iit kharagpur
iit kharagpur lecture::iit kharagpur lecture
emergence of networks::emergence of networks
networks & reference::networks & reference
professor sujoy ghosh::professor sujoy ghosh
ghosh of iit::ghosh of iit
science and engineering::science and engineering
emergence of computer::emergence of computer
protocols and reference::protocols and reference
view of computer::view of computer
networks the text::networks the text
top down approach::top down approach
featuring the internet::featuring the internet
internet by kurose::internet by kurose
data and communication::data and communication
communication by william::communication by william
stallings and computer::stallings and computer
books the first::books the first
network ? computer::network ? computer
number of computers::number of computers
lines two computers::lines two computers
two computers connected::two computers connected
network can communicate::network can communicate
means that computer::means that computer
network in order::network in order
order to communicate::order to communicate
nodes are computers::nodes are computers
kinds of network::kinds of network
devices like switches::devices like switches
facilitate the communication::facilitate the communication
communication and running::communication and running
switches and routers::switches and routers
presently the computers::presently the computers
computers can communicate::computers can communicate
kind of information::kind of information
basic and major::basic and major
computers can replace::computers can replace
replace a large::replace a large
computation to perform::computation to perform
pieces and assign::pieces and assign
computers the small::computers the small
form the final::form the final
coming into vogue::coming into vogue
mode of communication::mode of communication
communicate through voice::communicate through voice
communicate through video::communicate through video
communication is converging::communication is converging
network and nowadays::network and nowadays
communication are converging::communication are converging
necessarily of distributed::necessarily of distributed
railway reservation system::railway reservation system
computer to handle::computer to handle
place and form::place and form
form a huge::form a huge
distribute this functionality::distribute this functionality
functionality that means::functionality that means
examples of distributed::examples of distributed
distributed reservation system::distributed reservation system
kinds of distributed::kinds of distributed
kinds of applications::kinds of applications
application of networks::application of networks
focus on computer::focus on computer
first commercial computer::first commercial computer
commercial computer installed::commercial computer installed
first us communication::first us communication
satellite became operational::satellite became operational
operational the network::operational the network
channels and satellite::channels and satellite
medium of communication::medium of communication
airline reservation system::airline reservation system
packet switching network::packet switching network
first packet switching::first packet switching
switching network began::switching network began
began its operation::began its operation
water shed event::water shed event
computer networks developed::computer networks developed
first computer chip::first computer chip
computers were made::computers were made
low level gates::low level gates
first four-bit small::first four-bit small
four-bit small computer::four-bit small computer
small computer chip::small computer chip
specification was formulated::specification was formulated
important network protocols::important network protocols
version of network::version of network
network in sna::network in sna
first commercial microcomputer::first commercial microcomputer
alan and bill::alan and bill
eventually formed microsoft::eventually formed microsoft
woznaik and jobs::woznaik and jobs
jobs built apple1::jobs built apple1
apple1 so apple::apple1 so apple
lot of contribution::lot of contribution
contribution to make::contribution to make
make to computers::make to computers
aspects and windows::aspects and windows
started from apple::started from apple
visicalc first commercial::visicalc first commercial
first commercial spreadsheet::first commercial spreadsheet
application of computers::application of computers
computers these days::computers these days
ibm introduced ibm::ibm introduced ibm
drive and hard::drive and hard
protocols are arranged::protocols are arranged
apple introduced gui::apple introduced gui
gui with apple::gui with apple
first laptop pcs::first laptop pcs
microsoft releases windows::microsoft releases windows
national sound foundation::national sound foundation
foundation of usa::foundation of usa
usa replaces arpanet::usa replaces arpanet
arpanet as internet::arpanet as internet
www was invented::www was invented
invented by cern::invented by cern
cern physicist tim::cern physicist tim
physicist tim burners::physicist tim burners
tim burners lee::tim burners lee
advent of www::advent of www
world wide web::world wide web
made the network::made the network
network very popular::network very popular
kind of positive::kind of positive
showed their interest::showed their interest
commercial companies developed::commercial companies developed
people became interested::people became interested
growth of network::growth of network
phenomenal the basic::phenomenal the basic
application which attracted::application which attracted
people to networks::people to networks
mosaic released first::mosaic released first
released first gui::released first gui
first gui web::first gui web
gui web browser::gui web browser
popular web browser::popular web browser
version of microsoft::version of microsoft
so-called .com meltdown::so-called .com meltdown
meltdown that means::meltdown that means
growth of computers::growth of computers
development of networks::development of networks
utility and importance::utility and importance
scene in mid-1960s::scene in mid-1960s
department of defense::department of defense
wanted a command::wanted a command
command and control::command and control
survive a nuclear::survive a nuclear
wanted a distributed::wanted a distributed
project the subnet::project the subnet
subnet should consists::subnet should consists
intermediate message processors::intermediate message processors
kind of early::kind of early
early network devices::early network devices
lines these imps::lines these imps
imps ? intermediate::imps ? intermediate
connected by telephone::connected by telephone
lines from telephone::lines from telephone
software was changed::software was changed
changed to terminal::changed to terminal
terminal interface processor::terminal interface processor
allowed the connection::allowed the connection
connection of terminals::connection of terminals
setup a machine::setup a machine
universities could dial::universities could dial
people were interested::people were interested
upgraded their systems::upgraded their systems
ways in mid-1980s::ways in mid-1980s
mid-1980s nsf built::mid-1980s nsf built
backbone to connect::backbone to connect
connect with super::connect with super
super computing centers::super computing centers
networks its backbone::networks its backbone
mbps fiber backbone::mbps fiber backbone
allowed network connection::allowed network connection
connection to thousands::connection to thousands
thousands of universities::thousands of universities
commercial houses began::commercial houses began
began to notice::began to notice
decentralized model began::decentralized model began
commercial people joined::commercial people joined
lot of innovation::lot of innovation
lot of people::lot of people
major driving forces::major driving forces
role of so-called::role of so-called
start up companies::start up companies
companies start-up companies::companies start-up companies
start-up companies means::start-up companies means
buy their company::buy their company
company or give::company or give
give them money::give them money
kind of technology::kind of technology
people got interested::people got interested
.com companies crashed::.com companies crashed
field of networks::field of networks
walks of life::walks of life
kind of structure::kind of structure
mentioned that computer::mentioned that computer
number of nodes::number of nodes
nodes and nodes::nodes and nodes
computers or network::computers or network
lines sometimes things::lines sometimes things
giving us point-to-point::giving us point-to-point
communication that means::communication that means
means one node::means one node
physically a copper::physically a copper
line or fiber::line or fiber
means that communication::means that communication
means the communication::means the communication
kinds of dedicated::kinds of dedicated
share a point::share a point
point to point::point to point
medium that means::medium that means
ais and bis::ais and bis
bis could communicate::bis could communicate
done this business::done this business
business of sharing::business of sharing
sharing a link::sharing a link
sharing this link::sharing this link
link by multiple::link by multiple
kinds of point-to-point::kinds of point-to-point
links but point-to-point::links but point-to-point
kind of link::kind of link
throws its signal::throws its signal
make temporary point-to-point::make temporary point-to-point
temporary point-to-point links::temporary point-to-point links
broadcast tv signals::broadcast tv signals
shared between multiple::shared between multiple
multiple access medium::multiple access medium
users are connected::users are connected
kind of medium::kind of medium
protocol of deciding::protocol of deciding
kind of protocol::kind of protocol
protocol called multiple::protocol called multiple
shared broadcast medium::shared broadcast medium
broadcasting and point-to-point::broadcasting and point-to-point
send some things::send some things
group of friends::group of friends
computer networks networks::computer networks networks
networks are divided::networks are divided
divided into local::divided into local
local area network::local area network
metropolitan area network::metropolitan area network
wide area network::wide area network
area network local::area network local
network local area::network local area
area network means::area network means
building or small::building or small
group of buildings::group of buildings
size is small::size is small
things about local::things about local
make the issues::make the issues
issues of local::issues of local
larger area network::larger area network
picture ? ownership::picture ? ownership
case in wide::case in wide
network in wide::network in wide
network the nodes::network the nodes
nodes may belong::nodes may belong
policies that makes::policies that makes
makes wide area::makes wide area
wide area networking::wide area networking
local area networking::local area networking
area networking metropolitan::area networking metropolitan
networking metropolitan area::networking metropolitan area
means a network::means a network
size is bigger::size is bigger
bigger than local::bigger than local
local area networks::local area networks
make the entire::make the entire
entire community networked::entire community networked
geographically more distributed::geographically more distributed
simply draw valve::simply draw valve
connect the people::connect the people
area network wide::area network wide
network wide area::network wide area
wide area networks::wide area networks
hundreds or thousands::hundreds or thousands
thousands of kilometers::thousands of kilometers
kilometers the communication::kilometers the communication
interested in network::interested in network
number of people::number of people
input into bringing::input into bringing
make things cheaper::make things cheaper
thing became cheaper::thing became cheaper
cheaper and cheaper::cheaper and cheaper
wanted to join::wanted to join
join the network::join the network
area network cost::area network cost
issue wide area::issue wide area
connect various local::connect various local
network of networks::network of networks
networks or internetwork::networks or internetwork
internetwork or internet::internetwork or internet
networks in general::networks in general
general in formal::general in formal
protocols in network::protocols in network
protocols in networks::protocols in networks
networks because networks::networks because networks
done if people::done if people
basis to communicate::basis to communicate
numbers of protocols::numbers of protocols
protocol these protocols::protocol these protocols
two different interfaces::two different interfaces
interface that defines::interface that defines
defines the operations::defines the operations
protocol and peer::protocol and peer
peer to peer::peer to peer
interface which defines::interface which defines
defines messages exchanged::defines messages exchanged
exchanged with peer::exchanged with peer
protocol this protocol::protocol this protocol
protocol is supposed::protocol is supposed
supposed to achieve::supposed to achieve
business is broken::business is broken
functioning of computer::functioning of computer
networks we break::networks we break
networks are organized::networks are organized
organized as series::organized as series
series of layers::series of layers
layers the task::layers the task
give some service::give some service
maintains a virtual::maintains a virtual
peer any layer::peer any layer
running the peer-to-peer::running the peer-to-peer
interface the task::interface the task
performs certain subtask::performs certain subtask
performs some task::performs some task
similarly for performing::similarly for performing
performing this task::performing this task
layer this layer::layer this layer
subtask is done::subtask is done
peer-to-peer protocol running::peer-to-peer protocol running
layers the interface::layers the interface
defined another point::defined another point
connection ? virtual::connection ? virtual
virtual connection means::virtual connection means
means that physical::means that physical
computers are connected::computers are connected
connected by wire::connected by wire
connected in order::connected in order
hopping from node::hopping from node
node to node::node to node
reaching its destination::reaching its destination
direct physical communication::direct physical communication
surfing the internet::surfing the internet
connected to opposite::connected to opposite
remote web server::remote web server
virtual the physical::virtual the physical
piece of wires::piece of wires
wires or fiber::wires or fiber
fiber optic links::fiber optic links
connection for running::connection for running
node is transparent::node is transparent
means some company::means some company
upper layer service::upper layer service
two particular layers::two particular layers
two particular nodes::two particular nodes
protocol is concerned::protocol is concerned
expecting these kinds::expecting these kinds
kinds of answer::kinds of answer
kinds of messages::kinds of messages
kind of answer::kind of answer
companies are free::companies are free
free to develop::free to develop
develop their product::develop their product
people can innovate::people can innovate
people can put::people can put
network operating system::network operating system
complexity is special::complexity is special
implementer one implementer::implementer one implementer
implementer has decided::implementer has decided
decided to implement::decided to implement
lot of details::lot of details
fairly general picture::fairly general picture
networking is done::networking is done
business of developing::business of developing
nuts and bolts::nuts and bolts
peers all agree::peers all agree
changing the protocol::changing the protocol
communication will breakdown::communication will breakdown
thing about layering::thing about layering
change i make::change i make
specifics of implementation::specifics of implementation
tells the process::tells the process
osi reference model::osi reference model
widely used osi::widely used osi
important tcp reference::important NNP reference
tcp reference model::NNP reference model
kind of reference::kind of reference
basically a description::basically a description
layer is supposed::layer is supposed
number of layers::number of layers
stacks we call::stacks we call
protocol stacks exits::protocol stacks exits
lot of thought::lot of thought
data link layer::data link layer
order that people::order that people
people can communicate::people can communicate
layers ? application::layers ? application
link and physical::link and physical
layer each layer::layer each layer
kind of functionality::kind of functionality
functionalities together give::functionalities together give
adds a header::adds a header
sends the message::sends the message
scheme the point::scheme the point
suppose we start::suppose we start
case of osi::case of osi
layer some communication::layer some communication
layer this application::layer this application
application layer program::application layer program
program is running::program is running
doing a telnet::doing a telnet
kind of thing::kind of thing
start a telnet::start a telnet
telnet client program::telnet client program
machine will respond::machine will respond
respond to telnet::respond to telnet
server can respond::server can respond
telnet client telnet::telnet client telnet
client telnet server::client telnet server
layer how telnet::layer how telnet
application layer protocol::application layer protocol
client will request::client will request
server will respond::server will respond
internals of telnet::internals of telnet
program is concerned::program is concerned
idea of layering::idea of layering
layering so give::layering so give
data to send::data to send
kinds of data::kinds of data
node the lower::node the lower
running a protocol::running a protocol
layer is running::layer is running
message to add::message to add
add to give::add to give
fatter and fatter::fatter and fatter
out the message::out the message
sending a message::sending a message
message is received::message is received
header that means::header that means
machine that means::machine that means
means some dos::means some dos
two different machines::two different machines
layer will add::layer will add
thing becomes data::thing becomes data
session layer session::session layer session
layer session layer::layer session layer
data becomes fatter::data becomes fatter
fat packet travels::fat packet travels
layer will strip::layer will strip
peers can communicate::peers can communicate
transmit the bits::transmit the bits
difference between transmitting::difference between transmitting
bits and transmitting::bits and transmitting
matter of data::matter of data
data link computers::data link computers
route the packets::route the packets
segregated and put::segregated and put
original application layer::original application layer
concept of packet::concept of packet
layer the session::layer the session
manages the virtual::manages the virtual
layer it manages::layer it manages
connection the presentation::connection the presentation
layer that means::layer that means
encode and decode::encode and decode
messages that means::messages that means
two different ways::two different ways
ways of encoding::ways of encoding
job the human::job the human
user is interested::user is interested
variety of protocols::variety of protocols
things ; examples::things ; examples
sending a mail::sending a mail
telneting that means::telneting that means
means the telnet::means the telnet
machine as part::machine as part
reliable and cheap::reliable and cheap
layer is concerned::layer is concerned
peer some examples::peer some examples
examples of peers::examples of peers
nodes given service::nodes given service
application layer hands::application layer hands
layer which handles::layer which handles
handles the format::handles the format
computers to share::computers to share
share a connection::share a connection
packetize this data::packetize this data
user is concerned::user is concerned
connection this connection::connection this connection
connection is handled::connection is handled
provide check points::provide check points
distance ? dialogue::distance ? dialogue
layer and ensure::layer and ensure
pieces all arrive::pieces all arrive
out of order::out of order
cheap and efficient::cheap and efficient
types of transport::types of transport
kind of channel::kind of channel
channel or broadcasting::channel or broadcasting
broadcasting of messages::broadcasting of messages
messages to multiple::messages to multiple
network layer decides::network layer decides
message ultimately reaches::message ultimately reaches
reaches the destination::reaches the destination
destination it controls::destination it controls
controls the broadcasting::controls the broadcasting
handles technological mismatches::handles technological mismatches
handles billing information::handles billing information
link layer makes::link layer makes
makes the physical::makes the physical
physical link layer::physical link layer
free of transmission::free of transmission
link layer handles::link layer handles
handles this error::handles this error
transmitted as raw::transmitted as raw
session and presentation::session and presentation
match the essential::match the essential
essential functions match::essential functions match
kinds of protocols::kinds of protocols
structures of networks::structures of networks
view of networks::view of networks
handle different structures::handle different structures
preview computer networks::preview computer networks
discuss the network::discuss the network
basically a computer::basically a computer
kind of graph::kind of graph
general not feasible::general not feasible
pair of nodes::pair of nodes
today a network::today a network
nodes representing computers::nodes representing computers
links represent communication::links represent communication
represent communication links::represent communication links
communication links modes::communication links modes
modes of communication::modes of communication
broadcast or point::broadcast or point
lan topologies lan::lan topologies lan
area network topologies::area network topologies
common ; star::common ; star
kind of network::kind of network
shared broadcast links::shared broadcast links
pair of communicating::pair of communicating
send his message::send his message
ignore the communication::ignore the communication
shared broadcast link::shared broadcast link
ignore this communication::ignore this communication
protocol to decide::protocol to decide
pairs of node::pairs of node
happen that things::happen that things
computer networks::computer networks
networks prof::networks prof
prof sujoy::prof sujoy
sujoy ghosh::sujoy ghosh
ghosh iit::ghosh iit
iit kharagpur::iit kharagpur
kharagpur lecture::kharagpur lecture
reference models::reference models
good day::good day
professor sujoy::professor sujoy
computer science::computer science
engineering department::engineering department
series today::series today
introductory lecture::introductory lecture
abstract view::abstract view
text books::text books
computer networking::computer networking
approach featuring::approach featuring
kurose data::kurose data
william stallings::william stallings
first question::first question
computer network::computer network
communication lines::communication lines
computers connected::computers connected
indirect communication::indirect communication
network devices::network devices
entire network::entire network
exchange information::exchange information
small computers::small computers
large computer::large computer
large computation::large computation
small pieces::small pieces
small chunk::small chunk
final solution::final solution
communication tool::communication tool
send emails::send emails
direct communication::direct communication
computing communication::computing communication
distributed nature::distributed nature
railway reservation::railway reservation
reservation system::reservation system
railway reservations::railway reservations
huge queue::huge queue
booking tickets::booking tickets
distributed systems::distributed systems
distributed reservation::distributed reservation
distributed databases::distributed databases
first commercial::first commercial
commercial computer::commercial computer
computer installed::computer installed
big company::big company
communication channels::communication channels
satellite communication::satellite communication
important medium::important medium
airline reservation::airline reservation
packet switching::packet switching
switching network::switching network
rand corporation::rand corporation
first packet::first packet
network began::network began
water shed::water shed
shed event::shed event
reaching impact::reaching impact
networks developed::networks developed
first computer::first computer
computer chip::computer chip
previous computers::previous computers
low level::low level
level gates::level gates
first four-bit::first four-bit
small computer::small computer
ethernet specification::ethernet specification
ethernet remains::ethernet remains
important network::important network
network protocols::network protocols
ibm introduced::ibm introduced
commercial microcomputer::commercial microcomputer
paul alan::paul alan
bill gates::bill gates
formed microsoft::formed microsoft
jobs built::jobs built
built apple1::built apple1
windows system::windows system
apple computers::apple computers
commercial spreadsheet::commercial spreadsheet
popular application::popular application
introduced ibm::introduced ibm
floppy drive::floppy drive
hard drive::hard drive
network protocol::network protocol
cover today::cover today
important protocol::important protocol
prevalent today::prevalent today
official protocol::official protocol
arpanet arpanet::arpanet arpanet
far-reaching impact::far-reaching impact
network developed::network developed
introduced gui::introduced gui
apple macintosh::apple macintosh
first laptop::first laptop
laptop pcs::laptop pcs
microsoft releases::microsoft releases
releases windows::releases windows
multitasking system::multitasking system
microsoft version::microsoft version
national sound::national sound
sound foundation::sound foundation
usa replaces::usa replaces
replaces arpanet::replaces arpanet
internet backbone::internet backbone
cern physicist::cern physicist
physicist tim::physicist tim
tim burners::tim burners
burners lee::burners lee
world wide::world wide
wide web::wide web
positive feedback::positive feedback
people jumped::people jumped
people showed::people showed
commercial companies::commercial companies
companies developed::companies developed
positive loop::positive loop
past decade::past decade
absolutely phenomenal::absolutely phenomenal
first gui::first gui
gui web::gui web
web browser::web browser
popular web::popular web
microsoft explorer::microsoft explorer
so-called .com::so-called .com
.com meltdown::.com meltdown
means people::means people
importance remains::importance remains
general talking::general talking
computer scene::computer scene
defense wanted::defense wanted
control network::control network
nuclear attack::nuclear attack
strong reason::strong reason
distributed system::distributed system
intermediate message::intermediate message
message processors::message processors
early network::early network
kbps lines::kbps lines
telephone lines::telephone lines
telephone companies::telephone companies
imp software::imp software
terminal interface::terminal interface
interface processor::interface processor
nsf setup::nsf setup
machine connected::machine connected
mid-1980s nsf::mid-1980s nsf
nsf built::nsf built
computing centers::computing centers
regional networks::regional networks
mbps fiber::mbps fiber
fiber backbone::fiber backbone
allowed network::allowed network
network connection::network connection
research labs::research labs
growth continued::growth continued
commercial houses::commercial houses
houses began::houses began
decentralized model::decentralized model
model began::model began
commercial people::commercial people
people joined::people joined
major driving::major driving
driving forces::driving forces
computing networks::computing networks
past decades::past decades
so-called start::so-called start
companies start-up::companies start-up
start-up companies::start-up companies
companies means::companies means
young engineers::young engineers
young people::young people
bright idea::bright idea
success stories::success stories
explosive growth::explosive growth
21st century::21st century
stock exchanges::stock exchanges
.com companies::.com companies
companies crashed::companies crashed
historical background::historical background
point-to-point communication::point-to-point communication
direct line::direct line
copper line::copper line
fiber line::fiber line
point-to-point connection::point-to-point connection
simplest case::simplest case
dedicated case::dedicated case
simplex communication::simplex communication
full duplex::full duplex
dedicated lines::dedicated lines
point medium::point medium
single line::single line
multiple people::multiple people
point-to-point links::point-to-point links
broadcast kind::broadcast kind
satellite throws::satellite throws
point-to-point link::point-to-point link
shared medium::shared medium
temporary point-to-point::temporary point-to-point
broadcast media::broadcast media
multiple users::multiple users
multiple access::multiple access
access medium::access medium
distributed fashion::distributed fashion
broadcast medium::broadcast medium
shared broadcast::shared broadcast
communication link::communication link
networks networks::networks networks
local area::local area
area network::area network
metropolitan area::metropolitan area
wide area::wide area
network means::network means
small group::small group
larger area::larger area
privately owned::privately owned
area networking::area networking
networking metropolitan::networking metropolitan
area networks::area networks
access issues::access issues
entire community::entire community
community networked::community networked
network wide::network wide
historically happened::historically happened
technology developed::technology developed
technology improved::technology improved
people started::people started
company developing::company developing
network area::network area
make things::make things
things cheaper::things cheaper
people wanted::people wanted
network cost::network cost
issue wide::issue wide
abstract idea::abstract idea
formal framework::formal framework
common basis::common basis
minimum protocol::minimum protocol
building blocks::building blocks
network architecture::network architecture
protocol object::protocol object
service interface::service interface
peer interface::peer interface
defines messages::defines messages
layered architecture::layered architecture
networking business::networking business
upper layer::upper layer
layer maintains::layer maintains
virtual connection::virtual connection
peer-to-peer protocol::peer-to-peer protocol
layer performs::layer performs
lower layer::lower layer
peer-to-peer level::peer-to-peer level
protocol running::protocol running
communicating layers::communicating layers
connection means::connection means
physical connection::physical connection
indirect connection::indirect connection
direct physical::direct physical
physical communication::physical communication
opposite part::opposite part
remote web::remote web
web server::web server
lowest layer::lowest layer
optic links::optic links
satellite links::satellite links
main point::main point
layer architecture::layer architecture
service layers::service layers
layer service::layer service
thing applies::thing applies
ibm machine::ibm machine
sun machine::sun machine
operating system::operating system
peer protocol::peer protocol
unnecessary details::unnecessary details
network operating::network operating
networking device::networking device
general picture::general picture
entire networking::entire networking
peer layers::peer layers
good thing::good thing
service definition::service definition
interface tells::interface tells
layered models::layered models
osi reference::osi reference
reference model::reference model
networking technology::networking technology
complex technology::complex technology
osi stacks::osi stacks
atm stacks::atm stacks
protocol stacks::protocol stacks
stacks exits::stacks exits
application layer::application layer
presentation layer::presentation layer
session layer::session layer
network layer::network layer
data link::data link
link layer::link layer
physical layer::physical layer
seamless manner::seamless manner
peer-level communication::peer-level communication
sending machine::sending machine
layer adds::layer adds
peer level::peer level
bottom layer::bottom layer
tcp machine::tcp machine
general scheme::general scheme
destination machine::destination machine
layer program::layer program
telnet kind::telnet kind
telnet program::telnet program
telnet client::telnet client
client program::client program
telnet server::telnet server
client telnet::client telnet
remote machine::remote machine
layer protocol::layer protocol
telnet protocol::telnet protocol
application program::application program
target machine::target machine
original data::original data
originating machine::originating machine
receiving side::receiving side
layer reads::layer reads
source machine::source machine
dos machine::dos machine
microsoft dos::microsoft dos
ibm dos::ibm dos
layer session::layer session
fat packet::fat packet
packet travels::packet travels
actual connection::actual connection
protocol layers::protocol layers
physical link::physical link
transmit frames::transmit frames
transmitting bits::transmitting bits
transmitting frames::transmitting frames
direct connection::direct connection
link computers::link computers
direct link::direct link
transport layer::transport layer
send packets::send packets
application packet::application packet
original application::original application
make packets::make packets
decode messages::decode messages
encoding things::encoding things
actual job::actual job
human user::human user
ftp protocol::ftp protocol
download files::download files
web pages::web pages
sending mails::sending mails
unix machine::unix machine
smtp protocol::smtp protocol
telnet sever::telnet sever
cheap connection::cheap connection
layer hands::layer hands
protocol conversion::protocol conversion
data translation::data translation
data compression::data compression
data encryption::data encryption
continuous connection::continuous connection
provide check::provide check
check points::check points
original state::original state
dialogue control::dialogue control
basic function::basic function
accept data::accept data
smaller units::smaller units
packets pass::packets pass
right order::right order
efficient manner::efficient manner
transport services::transport services
multiple protocols::multiple protocols
point-to-point channels::point-to-point channels
cheap kind::cheap kind
multiple destinations::multiple destinations
transport service::transport service
layer decides::layer decides
intended message::intended message
technological mismatches::technological mismatches
congestion control::congestion control
billing information::billing information
layer makes::layer makes
transmission errors::transmission errors
layer handles::layer handles
error correction::error correction
lowest level::lowest level
raw bits::raw bits
rough correspondence::rough correspondence
essential functions::essential functions
functions match::functions match
preview computer::preview computer
network topology::network topology
quick recap::quick recap
communication links::communication links
nodes connected::nodes connected
subject matter::subject matter
discussion today::discussion today
representing computers::representing computers
links represent::links represent
represent communication::represent communication
links modes::links modes
lan topologies::lan topologies
topologies lan::topologies lan
network topologies::network topologies
bus topology::bus topology
simple kind::simple kind
broadcast links::broadcast links
point communication::point communication
communicating nodes::communicating nodes
broadcast link::broadcast link
distributed protocol::distributed protocol
computer::computer
networks::networks
prof::prof
sujoy::sujoy
ghosh::ghosh
iit::iit
kharagpur::kharagpur
lecture::lecture
emergence::emergence
reference::reference
models::models
good::good
day::day
professor::professor
teach::teach
science::science
engineering::engineering
department::department
taking::taking
lectures::lectures
series::series
today::today
start::start
introductory::introductory
history::history
bit::bit
protocols::protocols
abstract::abstract
view::view
text::text
books::books
networking::networking
top::top
approach::approach
featuring::featuring
internet::internet
kurose::kurose
data::data
communication::communication
william::william
stallings::stallings
tanenbaum::tanenbaum
material::material
covering::covering
verbally::verbally
slides::slides
first::first
question::question
network::network
number::number
computers::computers
nodes::nodes
connected::connected
lines::lines
two::two
communicate::communicate
directly::directly
means::means
order::order
indirect::indirect
point::point
devices::devices
kinds::kinds
switches::switches
routers::routers
facilitate::facilitate
running::running
entire::entire
finally::finally
types::types
presently::presently
exchange::exchange
information::information
kind::kind
program::program
basic::basic
major::major
specialized::specialized
interconnected::interconnected
small::small
replace::replace
large::large
computation::computation
perform::perform
powerful::powerful
costly::costly
option::option
break::break
work::work
pieces::pieces
assign::assign
chunk::chunk
problem::problem
form::form
final::final
solution::solution
coming::coming
vogue::vogue
days::days
tool::tool
send::send
emails::emails
cheap::cheap
fast::fast
mode::mode
direct::direct
voice::voice
video::video
converging::converging
nowadays::nowadays
talk::talk
bedrock::bedrock
computing::computing
applications::applications
necessarily::necessarily
distributed::distributed
nature::nature
railway::railway
reservation::reservation
system::system
handle::handle
reservations::reservations
world::world
place::place
people::people
huge::huge
queue::queue
distribute::distribute
functionality::functionality
booking::booking
tickets::tickets
country::country
examples::examples
systems::systems
similarly::similarly
databases::databases
application::application
30-5::30-5
quick::quick
focus::focus
commercial::commercial
installed::installed
univac::univac
big::big
company::company
satellite::satellite
operational::operational
component::component
channels::channels
important::important
medium::medium
airline::airline
packet::packet
switching::switching
proposed::proposed
rand::rand
corporation::corporation
arpanet::arpanet
began::began
operation::operation
water::water
shed::shed
event::event
reaching::reaching
impact::impact
developed::developed
chip::chip
previous::previous
made::made
low::low
level::level
gates::gates
four-bit::four-bit
transistors::transistors
ethernet::ethernet
specification::specification
formulated::formulated
protocol::protocol
remains::remains
ibm::ibm
introduced::introduced
version::version
sna::sna
altair::altair
microcomputer::microcomputer
sold::sold
kit::kit
17-09::17-09
paul::paul
alan::alan
bill::bill
eventually::eventually
formed::formed
microsoft::microsoft
woznaik::woznaik
jobs::jobs
built::built
apple1::apple1
apple::apple
lot::lot
contribution::contribution
make::make
aspects::aspects
windows::windows
basically::basically
started::started
visicalc::visicalc
spreadsheet::spreadsheet
popular::popular
floppy::floppy
drive::drive
changed::changed
hard::hard
arranged::arranged
cover::cover
part::part
prevalent::prevalent
official::official
set::set
usa::usa
drdo::drdo
far-reaching::far-reaching
gui::gui
macintosh::macintosh
laptop::laptop
pcs::pcs
multitasking::multitasking
releases::releases
nsf::nsf
national::national
sound::sound
foundation::foundation
replaces::replaces
backbone::backbone
www::www
invented::invented
cern::cern
physicist::physicist
tim::tim
burners::burners
lee::lee
advent::advent
wide::wide
web::web
positive::positive
feedback::feedback
jumped::jumped
showed::showed
interest::interest
companies::companies
interested::interested
market::market
naturally::naturally
easier::easier
functionalities::functionalities
loop::loop
growth::growth
past::past
decade::decade
90s::90s
absolutely::absolutely
phenomenal::phenomenal
killerapp::killerapp
attracted::attracted
mosaic::mosaic
released::released
browser::browser
netscape::netscape
explorer::explorer
frenzy::frenzy
.com::.com
so-called::so-called
meltdown::meltdown
frenzied::frenzied
forever::forever
halt::halt
development::development
utility::utility
importance::importance
focused::focused
general::general
talking::talking
scene::scene
mid-1960s::mid-1960s
defense::defense
wanted::wanted
command::command
control::control
survive::survive
nuclear::nuclear
attack::attack
strong::strong
reason::reason
seed::seed
project::project
subnet::subnet
consists::consists
honeywell::honeywell
intermediate::intermediate
message::message
processors::processors
early::early
kbps::kbps
imps::imps
telephone::telephone
imp::imp
software::software
terminal::terminal
interface::interface
processor::processor
allowed::allowed
connection::connection
terminals::terminals
1970s::1970s
setup::setup
machine::machine
universities::universities
dial::dial
connect::connect
sense::sense
upgraded::upgraded
ways::ways
mid-1980s::mid-1980s
super::super
centers::centers
regional::regional
mbps::mbps
fiber::fiber
thousands::thousands
research::research
labs::labs
libraries::libraries
museums::museums
continued::continued
houses::houses
notice::notice
join::join
decentralized::decentralized
model::model
hold::hold
described::described
earlier::earlier
joined::joined
innovation::innovation
driving::driving
forces::forces
decades::decades
role::role
start-up::start-up
young::young
engineers::engineers
bright::bright
idea::idea
extent::extent
proven::proven
possibly::possibly
buy::buy
give::give
money::money
access::access
technology::technology
success::success
stories::stories
explosive::explosive
21st::21st
century::century
stock::stock
exchanges::exchanges
crashed::crashed
field::field
walks::walks
life::life
continuing::continuing
historical::historical
background::background
structure::structure
mentioned::mentioned
things::things
simple::simple
line::line
giving::giving
point-to-point::point-to-point
node::node
communicating::communicating
physically::physically
copper::copper
simplest::simplest
case::case
dedicated::dedicated
cases::cases
simplex::simplex
direction::direction
half::half
duplex::duplex
full::full
simultaneously::simultaneously
parallel::parallel
.these::.these
specifically::specifically
multiplexers::multiplexers
share::share
ais::ais
bis::bis
single::single
thing::thing
done::done
business::business
sharing::sharing
link::link
parallely::parallely
multiple::multiple
multiplexing::multiplexing
links::links
broadcast::broadcast
throws::throws
signal::signal
region::region
put::put
shared::shared
temporary::temporary
signals::signals
media::media
users::users
term::term
points::points
fashion::fashion
deciding::deciding
multiplex::multiplex
common::common
broadcasting::broadcasting
multicasting::multicasting
group::group
friends::friends
friend::friend
divided::divided
local::local
area::area
metropolitan::metropolitan
limited::limited
building::building
buildings::buildings
size::size
issues::issues
larger::larger
privately::privately
owned::owned
ownership::ownership
picture::picture
owner::owner
policy::policy
belong::belong
ideas::ideas
policies::policies
makes::makes
spread::spread
community::community
city::city
bigger::bigger
networked::networked
geographically::geographically
validers::validers
simply::simply
draw::draw
valve::valve
cost::cost
prohibitive::prohibitive
issue::issue
talked::talked
hundreds::hundreds
kilometers::kilometers
historically::historically
happened::happened
side::side
volumes::volumes
improved::improved
input::input
bringing::bringing
volume::volume
developing::developing
cheaper::cheaper
internetwork::internetwork
formal::formal
framework::framework
agree::agree
basis::basis
numbers::numbers
doing::doing
completely::completely
minimum::minimum
blocks::blocks
architecture::architecture
object::object
interfaces::interfaces
service::service
defines::defines
operations::operations
peer::peer
messages::messages
exchanged::exchanged
peers::peers
diagram::diagram
lis::lis
supposed::supposed
achieve::achieve
requires::requires
layer::layer
layered::layered
invade::invade
layers::layers
standards::standards
broken::broken
achieving::achieving
smooth::smooth
functioning::functioning
organized::organized
task::task
upper::upper
maintains::maintains
virtual::virtual
peer-to-peer::peer-to-peer
performs::performs
subtask::subtask
performing::performing
delegated::delegated
lower::lower
assuming::assuming
performed::performed
defined::defined
physical::physical
understand::understand
wire::wire
hopping::hopping
destination::destination
surfing::surfing
opposite::opposite
globe::globe
appears::appears
clicking::clicking
mouse::mouse
communicated::communicated
remote::remote
server::server
page::page
lowest::lowest
piece::piece
wires::wires
optic::optic
main::main
implementation::implementation
transparent::transparent
stop::stop
long::long
product::product
decide::decide
free::free
applies::applies
sun::sun
operating::operating
concerned::concerned
expecting::expecting
answer::answer
accept::accept
develop::develop
innovate::innovate
conforming::conforming
abstracting::abstracting
out::out
unnecessary::unnecessary
details::details
device::device
complex::complex
complexity::complexity
special::special
implementer::implementer
decided::decided
implement::implement
concentrate::concentrate
fairly::fairly
modules::modules
nuts::nuts
bolts::bolts
changing::changing
breakdown::breakdown
referred::referred
layering::layering
change::change
matter::matter
definition::definition
specifics::specifics
vary::vary
vendor::vendor
tells::tells
process::process
specifies::specifies
parameters::parameters
results::results
expected::expected
famous::famous
osi::osi
detail::detail
widely::widely
theoretical::theoretical
tcp::NNP
ubiquitous::ubiquitous
atm::atm
description::description
interfaced::interfaced
stacks::stacks
call::call
exits::exits
universally::universally
accepted::accepted
key::key
thought::thought
practice::practice
58-39::58-39
presentation::presentation
session::session
seamless::seamless
manner::manner
involved::involved
parts::parts
37-40::37-40
peer-level::peer-level
host::host
travels::travels
sending::sending
adds::adds
header::header
bottom::bottom
sends::sends
tcp::tcp
scheme::scheme
suppose::suppose
initiated::initiated
mind::mind
telnet::telnet
logging::logging
client::client
respond::respond
request::request
internals::internals
complicated::complicated
target::target
add::add
hand::hand
added::added
original::original
moves::moves
stack::stack
originating::originating
pair::pair
adding::adding
fatter::fatter
moved::moved
module::module
pick::pick
source::source
25-44::25-44
received::received
receiving::receiving
passed::passed
reads::reads
11-44::11-44
machines::machines
dos::dos
run::run
originated::originated
hop::hop
fat::fat
strip::strip
actual::actual
34-46::34-46
transmit::transmit
bits::bits
frames::frames
difference::difference
transmitting::transmitting
reach::reach
track::track
route::route
packets::packets
job::job
transport::transport
segregated::segregated
packaged::packaged
concept::concept
packetize::packetize
functions::functions
manages::manages
encode::encode
decode::decode
encoding::encoding
security::security
human::human
user::user
08-48::08-48
variety::variety
depends::depends
ftp::ftp
smtp::smtp
http::http
names::names
protocolsm::protocolsm
download::download
files::files
pages::pages
surf::surf
mails::mails
mail::mail
unix::unix
telneting::telneting
sever::sever
reliable::reliable
reliably::reliably
cheaply::cheaply
43-50::43-50
hands::hands
handles::handles
format::format
conversion::conversion
translation::translation
ascii::ascii
compression::compression
encryption::encryption
handled::handled
00-50::00-50
continuous::continuous
provide::provide
check::check
disruption::disruption
back::back
state::state
retransmit::retransmit
distance::distance
dialogue::dialogue
22-51::22-51
function::function
split::split
smaller::smaller
units::units
pass::pass
ensure::ensure
arrive::arrive
correctly::correctly
right::right
end::end
chopped::chopped
efficient::efficient
01-51::01-51
services::services
error-free::error-free
channel::channel
destinations::destinations
33-51::33-51
decides::decides
locally::locally
intended::intended
ultimately::ultimately
reaches::reaches
controls::controls
essentially::essentially
segregating::segregating
technological::technological
mismatches::mismatches
56-52::56-52
congestion::congestion
billing::billing
12-52::12-52
transmission::transmission
errors::errors
error::error
correction::correction
20-52::20-52
transmitted::transmitted
raw::raw
3-52::3-52
22-52::22-52
rough::rough
correspondence::correspondence
match::match
essential::essential
class::class
discussing::discussing
structures::structures
52-53::52-53
preview::preview
topology::topology
discuss::discuss
00-55::00-55
recap::recap
learnt::learnt
last::last
graph::graph
implication::implication
feasible::feasible
subject::subject
discussion::discussion
represented::represented
representing::representing
represent::represent
modes::modes
discussed::discussed
lan::lan
topologies::topologies
star::star
ring::ring
bus::bus
based::based
short::short
ignore::ignore
private::private
copy::copy
purpose::purpose
communications::communications
collide::collide
pairs::pairs
garbled::garbled
happen::happen
