sujoy ghosh lecture::sujoy ghosh lecture
discuss the network::discuss the network
basically a computer::basically a computer
number of nodes::number of nodes
call a graph::call a graph
representing the network::representing the network
network this graph::network this graph
structure we talk::structure we talk
structure this structure::structure this structure
general not feasible::general not feasible
pair of node::pair of node
matter of discussion::matter of discussion
nodes may represent::nodes may represent
computer or network::computer or network
devices like switches::devices like switches
links represent communication::links represent communication
represent communication links::represent communication links
communication links modes::communication links modes
modes of communication::modes of communication
broadcast or point::broadcast or point
point to point::point to point
lan topologies lan::lan topologies lan
local area network::local area network
network and local::network and local
area network topologies::area network topologies
ring and bus::ring and bus
kind of network::kind of network
shared broadcast link::shared broadcast link
pair of communicating::pair of communicating
send his message::send his message
ignore the communication::ignore the communication
links are shared::links are shared
ignore this communication::ignore this communication
protocol to decide::protocol to decide
communications will collide::communications will collide
shared broadcast medium::shared broadcast medium
medium the communication::medium the communication
pairs of node::pairs of node
cable a single::cable a single
single cable connects::single cable connects
computers are hanging::computers are hanging
cable each computer::cable each computer
computer is connected::computer is connected
cable so computers::cable so computers
computers must synchronize::computers must synchronize
computer to transmit::computer to transmit
single copper cable::single copper cable
cable and computers::cable and computers
network is maintained::network is maintained
single cable cable::single cable cable
cable cable segment::cable cable segment
segment must end::segment must end
sends a signal::sends a signal
kind of unwanted::kind of unwanted
types of coaxial::types of coaxial
thin coaxial cable::thin coaxial cable
cable called thin::cable called thin
thick coaxial cable::thick coaxial cable
cable called thick::cable called thick
lan and extra::lan and extra
daisy chain manner::daisy chain manner
manner this technology::manner this technology
technology is sort::technology is sort
thin and thick::thin and thick
people are moving::people are moving
problem in communication::problem in communication
obsolete these days::obsolete these days
single broadcast medium::single broadcast medium
machines are sharing::machines are sharing
topology is ieee::topology is ieee
eliminate that cable::eliminate that cable
cable and replace::cable and replace
range of segment::range of segment
meters the maximum::meters the maximum
number of connections::number of connections
devices four repeaters::devices four repeaters
total cable length::total cable length
signal gets weak::signal gets weak
regenerate the signal::regenerate the signal
incoming weak signal::incoming weak signal
send the stronger::send the stronger
line the maximum::line the maximum
nodes per segment::nodes per segment
advantages and disadvantages::advantages and disadvantages
easy to add::easy to add
cable and add::cable and add
add new station::add new station
station that means::station that means
computer the amount::computer the amount
amount of cable::amount of cable
recommended which means::recommended which means
parts any longer::parts any longer
out of fashion::out of fashion
number of devices::number of devices
difficult to isolate::difficult to isolate
isolate the problems::isolate the problems
slows the response::slows the response
direct point-to-point communication::direct point-to-point communication
communication that means::communication that means
dedicated point-to-point communication::dedicated point-to-point communication
communication so computers::communication so computers
computers are connected::computers are connected
connected by communication::connected by communication
network that means::network that means
pairs of nodes::pairs of nodes
flexibility in communication::flexibility in communication
security and privacy::security and privacy
privacy because communication::privacy because communication
number of cables::number of cables
cables you require::cables you require
means the number::means the number
length of cables::length of cables
kind of cable::kind of cable
previous thin lan::previous thin lan
kind of structure::kind of structure
area network suppose::area network suppose
means every node::means every node
node and length::node and length
nodes this means::nodes this means
easy to provide::easy to provide
kind of mesh::kind of mesh
alternative another reason::alternative another reason
two different buildings::two different buildings
lot of cables::lot of cables
reduce the number::reduce the number
number of communication::number of communication
idea of communicating::idea of communicating
lan it means::lan it means
necessarily we share::necessarily we share
share the connections::share the connections
ways of doing::ways of doing
computer takes turns::computer takes turns
include some technique::include some technique
technique for synchronizing::technique for synchronizing
common these days::common these days
topology a star::topology a star
nodes are connected::nodes are connected
star its physical::star its physical
hub is made::hub is made
advantage of converting::advantage of converting
previously a bus::previously a bus
cable the cable::cable the cable
handle the connections::handle the connections
long running cable::long running cable
difficult to locate::difficult to locate
locate loose connections::locate loose connections
find out failures::find out failures
physical star topology::physical star topology
topology still maintains::topology still maintains
maintains a logical::maintains a logical
logical bus topology::logical bus topology
case these days::case these days
previous star diagram::previous star diagram
diagram is idealized::diagram is idealized
kind of connection::kind of connection
ubiquitous these cables::ubiquitous these cables
kind of cables::kind of cables
cables which connect::cables which connect
connect your telephones::connect your telephones
cables or unshielded::cables or unshielded
unshielded twisted pair::unshielded twisted pair
twisted pair cables::twisted pair cables
easier to handle::easier to handle
cheaper these connections::cheaper these connections
lan or thick::lan or thick
extended star topology::extended star topology
means different stars::means different stars
manner that means::manner that means
means the hubs::means the hubs
stars are connected::stars are connected
switches these switches::switches these switches
switches are connected::switches are connected
topology some part::topology some part
medium some part::medium some part
coaxial cable running::coaxial cable running
leaving a thin::leaving a thin
topology in ring::topology in ring
lot of advantage::lot of advantage
first node passes::first node passes
passes the data::passes the data
reaches the destination::reaches the destination
reach the destination::reach the destination
destination will copy::destination will copy
short connected cable::short connected cable
ring ring connections::ring ring connections
connections may run::connections may run
run past offices::run past offices
offices with connector::offices with connector
cables to sockets::cables to sockets
ring the data::ring the data
put two rings::put two rings
reason for putting::reason for putting
putting two rings::putting two rings
nodes can sense::nodes can sense
sort of wrap::sort of wrap
wrap the ring::wrap the ring
nodes these nodes::nodes these nodes
node may break::node may break
link may fail::link may fail
things may happen::things may happen
wide area network::wide area network
lot of things::lot of things
exchanges are connected::exchanges are connected
fashion using fiber::fashion using fiber
fiber optics cable::fiber optics cable
cable is cut::cable is cut
beginning or end::beginning or end
ring all devices::ring all devices
devices have equal::devices have equal
access to media::access to media
media one good::media one good
ring allows fault::ring allows fault
tolerance each device::tolerance each device
wait its turn::wait its turn
turn to transmit::turn to transmit
transmit that means::transmit that means
token ring token::token ring token
ring token ring::ring token ring
ieee standard number::ieee standard number
data it reaches::data it reaches
data is extracted::data is extracted
acknowledgement of receipt::acknowledgement of receipt
back to transmitting::back to transmitting
empty token passed::empty token passed
make a data::make a data
kind of identification::kind of identification
bunch of data::bunch of data
data the destination::data the destination
extract the data::extract the data
acknowledgement and send::acknowledgement and send
remove this acknowledgement::remove this acknowledgement
token is passed::token is passed
send and send::send and send
disadvantages the advantages::disadvantages the advantages
data packets travel::data packets travel
travel at great::travel at great
reason why data::reason why data
packets can travel::packets can travel
synchronizing their actions::synchronizing their actions
two different nodes::two different nodes
nodes may start::nodes may start
data will collide::data will collide
ways of synchronization::ways of synchronization
easier to find::easier to find
faults and rectify::faults and rectify
faults and terminators::faults and terminators
cable the disadvantages::cable the disadvantages
requires more cable::requires more cable
couple of breakdowns::couple of breakdowns
breakdowns may bring::breakdowns may bring
bring the entire::bring the entire
ring down smaller::ring down smaller
smaller rings exist::smaller rings exist
rings exist nowadays::rings exist nowadays
network is concerned::network is concerned
network a ring::network a ring
matter of fact::matter of fact
fact the ring::fact the ring
topology that wide::topology that wide
topology use token::topology use token
passing for synchronized::passing for synchronized
ring the ring::ring the ring
single shared communication::single shared communication
shared communication medium::shared communication medium
communication medium bits::communication medium bits
medium bits pass::medium bits pass
pass from transmitter::pass from transmitter
past other computers::past other computers
copied by destination::copied by destination
designed to pass::designed to pass
out of commission::out of commission
ring can function::ring can function
computer is shut::computer is shut
sender holding token::sender holding token
holding token transmits::holding token transmits
token transmits bits::token transmits bits
bits of frames::bits of frames
computer not holding::computer not holding
holding the token::holding the token
passes the bits::passes the bits
speed the destination::speed the destination
makes a copy::makes a copy
receives the bits::receives the bits
network could work::network could work
token after transmission::token after transmission
transmission computer transmits::transmission computer transmits
computer transmits token::computer transmits token
ready to transmit::ready to transmit
transmit it receives::transmit it receives
transmits this token::transmits this token
fell into disuse::fell into disuse
token ring devices::token ring devices
dominant lan technology::dominant lan technology
lived on due::lived on due
tolerance this technology::tolerance this technology
ring is made::ring is made
made of fiber::made of fiber
fiber optic cables::fiber optic cables
optic cables multi::optic cables multi
cables multi mode::cables multi mode
multi mode fibers::multi mode fibers
single mode fibers::single mode fibers
fairly high speed::fairly high speed
level possible nowadays::level possible nowadays
nowadays fddi technology::nowadays fddi technology
speed may sound::speed may sound
sound less today::sound less today
speed the basic::speed the basic
inherent fault tolerance::inherent fault tolerance
fault tolerance capability::fault tolerance capability
fault tolerant ring::fault tolerant ring
tolerant ring technology::tolerant ring technology
technology whose full::technology whose full
form is fiber::form is fiber
fiber distributed data::fiber distributed data
distributed data interconnect::distributed data interconnect
optic between stations::optic between stations
order of magnitude::order of magnitude
pairs of fibers::pairs of fibers
fibers to form::fibers to form
form two concentric::form two concentric
two concentric rings::two concentric rings
rings in order::rings in order
tolerance we require::tolerance we require
stars will form::stars will form
fddi is configured::fddi is configured
configured some fddi::configured some fddi
fddi switches form::fddi switches form
form a ring::form a ring
start other kind::start other kind
kind of technologies::kind of technologies
technologies like ethernet::technologies like ethernet
form a tree-like::form a tree-like
networks are updated::networks are updated
updated and replaced::updated and replaced
leaving some older::leaving some older
replaced one part::replaced one part
part of network::part of network
kind of topology::kind of topology
types of topologies::types of topologies
topologies the common::topologies the common
bus or star::bus or star
star ring star::star ring star
ring star ring::ring star ring
multi-station access unit::multi-station access unit
basically a part::basically a part
part of fddi::part of fddi
study of mesh::study of mesh
meant a complete::meant a complete
graph as shown::graph as shown
lot of cable::lot of cable
lot of alternative::lot of alternative
node the diagram::node the diagram
shows eight nodes::shows eight nodes
path and indirect::path and indirect
destination this means::destination this means
arrangement takes lot::arrangement takes lot
nodes becomes disconnected::nodes becomes disconnected
form of redundancy::form of redundancy
level of fault::level of fault
mesh the network::mesh the network
difficult to evolve::difficult to evolve
evolve a protocol::evolve a protocol
protocol like token::protocol like token
token passing protocol::token passing protocol
method of sensing::method of sensing
sensing the faults::sensing the faults
faults and correcting::faults and correcting
partial mesh topology::partial mesh topology
common on lans::common on lans
wans to interconnect::wans to interconnect
lans because wan::lans because wan
costly the users::costly the users
link naturally expect::link naturally expect
grade of service::grade of service
wan service providers::wan service providers
paths becomes unavailable::paths becomes unavailable
failure or due::failure or due
send the traffic::send the traffic
pros and cons::pros and cons
cons of mesh::cons of mesh
improves fault tolerance::improves fault tolerance
carry more data::carry more data
data the disadvantages::data the disadvantages
increased cost installation::increased cost installation
difficulty in management::difficulty in management
management and troubleshooting::management and troubleshooting
topologies has advantages::topologies has advantages
disadvantages rings ease::disadvantages rings ease
rings ease synchronization::rings ease synchronization
cable breaks star::cable breaks star
star is easier::star is easier
easier to manage::easier to manage
cable bus requires::cable bus requires
bus requires fewer::bus requires fewer
requires fewer cables::requires fewer cables
disabled if cable::disabled if cable
lan is concerned::lan is concerned
people are gravitating::people are gravitating
gravitating towards star::gravitating towards star
topology that means::topology that means
means some nodes::means some nodes
fashion extended star::fashion extended star
emerging in local::emerging in local
local area networks::local area networks
networks in wide::networks in wide
wide area networks::wide area networks
cable ducts running::cable ducts running
cables are passing::cables are passing
connect two cables::connect two cables
pairs of cables::pairs of cables
make a star::make a star
access the medium::access the medium
medium and transmits::medium and transmits
topology a lan::topology a lan
revealing cables emerging::revealing cables emerging
necessarily a star::necessarily a star
piece of network::piece of network
hub this hub::hub this hub
hub actually replaces::hub actually replaces
replaces the single::replaces the single
star connection people::star connection people
people use hubs::people use hubs
hubs these days::hubs these days
cable like thin::cable like thin
lan and thick::lan and thick
kind of box::kind of box
choice of logical::choice of logical
affect the physical::affect the physical
kind of physical::kind of physical
dictate the kind::dictate the kind
kind of logical::kind of logical
actual physical topology::actual physical topology
type of network::type of network
boxes like switches::boxes like switches
difficult to change::difficult to change
change the part::change the part
designing a network::designing a network
put the physical::put the physical
physical topology min::physical topology min
topology min place::topology min place
correct logical topology::correct logical topology
topology your choice::topology your choice
choice will determine::choice will determine
determine cable installation::determine cable installation
cable installation network::cable installation network
connections and protocols::connections and protocols
protocols and spots::protocols and spots
account while deciding::account while deciding
kind of technology::kind of technology
kinds of lan::kinds of lan
topology the kind::topology the kind
kind of situation::kind of situation
question of scalability::question of scalability
choked or people::choked or people
users will join::users will join
happening a network::happening a network
putting some kind::putting some kind
scale the network::scale the network
change the number::change the number
bus by putting::bus by putting
put a switch::put a switch
star topology kind::star topology kind
kind of thing::kind of thing
design your physical::design your physical
ease of installation::ease of installation
ease of finding::ease of finding
central cabling plan::central cabling plan
cables are coming::cables are coming
central place .there::central place .there
.there are standards::.there are standards
standards like structured::standards like structured
easy fault finding::easy fault finding
finding and maintenance::finding and maintenance
lecture good day::lecture good day
day ! today::day ! today
talking about multiplexing::talking about multiplexing
sharing a medium::sharing a medium
medium different users::medium different users
medium for communication::medium for communication
carry one signal::carry one signal
.for multiple signals::.for multiple signals
signals to share::signals to share
share one medium::share one medium
divided to give::divided to give
give each signal::give each signal
signal a portion::signal a portion
portion of total::portion of total
communication is concerned::communication is concerned
facilitate the communication::facilitate the communication
number of pairs::number of pairs
pairs of senders::pairs of senders
senders and receivers.that::senders and receivers.that
idea of multiplexing::idea of multiplexing
leased lines packet::leased lines packet
lines packet switched::lines packet switched
packet switched networks::packet switched networks
laying of line::laying of line
expensive and complex::expensive and complex
lay a line::lay a line
amount of communication::amount of communication
multiplexing and compression::multiplexing and compression
compression techniques save::compression techniques save
save a lot::save a lot
lot of money::lot of money
send a lot::send a lot
lot of data::lot of data
line the data::line the data
company .most data::company .most data
.most data devices::.most data devices
devices individually require::devices individually require
individually require modest::individually require modest
require modest amount::require modest amount
amount of data::amount of data
number of users::number of users
users their aggregated::users their aggregated
requirements may occupy::requirements may occupy
technique to accomplish::technique to accomplish
accomplish this include::accomplish this include
include frequency division::include frequency division
frequency division multiplexing::frequency division multiplexing
wavelength division multiplexing::wavelength division multiplexing
multiplexing and code::multiplexing and code
code division multiplexing::code division multiplexing
scheme of multiplexing::scheme of multiplexing
inputs are coming::inputs are coming
physical link .on::physical link .on
number of sender::number of sender
sender receiver pairs::sender receiver pairs
pairs are utilizing::pairs are utilizing
alternative to multiplexing::alternative to multiplexing
number of problems::number of problems
problems .first problem::problems .first problem
amount of wiring::amount of wiring
multi drop line::multi drop line
host polls machine::host polls machine
lines total communications::lines total communications
total communications load::total communications load
rate of line::rate of line
line out link::line out link
out link carries::out link carries
link carries multiple::link carries multiple
carries multiple channels::carries multiple channels
channels of information::channels of information
quantum of noise::quantum of noise
.if the noise::.if the noise
noise is high::noise is high
lose some information::lose some information
loss of information::loss of information
case of digital::case of digital
compared to analog::compared to analog
errors in transmission::errors in transmission
transmission using digital::transmission using digital
signals we add::signals we add
add few bytes::add few bytes
bytes of error::bytes of error
error checking information::error checking information
error is detected::error is detected
bits called byte::bits called byte
add an extra::add an extra
byte would make::byte would make
make the number::make the number
end we find::end we find
flipped that means::flipped that means
means some bits::means some bits
number of bits::number of bits
bits are supposed::bits are supposed
adding one bit::adding one bit
original that means::original that means
means the sending::means the sending
station was odd::station was odd
.in that case::.in that case
case the receiver::case the receiver
receiver may request::receiver may request
request the sender::request the sender
sender to retransmit::sender to retransmit
kind of error::kind of error
sophisticated error checking::sophisticated error checking
error checking methods::error checking methods
checking methods employed::checking methods employed
employed in networks::employed in networks
networks and communications::networks and communications
computer networks::computer networks
sujoy ghosh::sujoy ghosh
ghosh lecture::ghosh lecture
network topology::network topology
good day::good day
quick recap::quick recap
computer network::computer network
communication links::communication links
graph representing::graph representing
one-to-one communication::one-to-one communication
structure formed::structure formed
nodes connected::nodes connected
subject matter::subject matter
discussion today::discussion today
graph nodes::graph nodes
represent computer::represent computer
network devices::network devices
links represent::links represent
represent communication::represent communication
links modes::links modes
lan topologies::lan topologies
topologies lan::topologies lan
local area::local area
area network::area network
network topologies::network topologies
bus topology::bus topology
simple kind::simple kind
shared broadcast::shared broadcast
broadcast link::broadcast link
point-to-point communication::point-to-point communication
communicating nodes::communicating nodes
distributed protocol::distributed protocol
broadcast medium::broadcast medium
clear signal::clear signal
simplest thing::simplest thing
single cable::single cable
cable connects::cable connects
shared cable::shared cable
simple network::simple network
single copper::single copper
cable segment::cable segment
properly terminated::properly terminated
unwanted noise::unwanted noise
coaxial cable::coaxial cable
coaxial cables::coaxial cables
thin coaxial::thin coaxial
thin lan::thin lan
thick coaxial::thick coaxial
thick lan::thick lan
extra stations::extra stations
daisy chain::daisy chain
chain manner::chain manner
thick lans::thick lans
main reason::main reason
loose connection::loose connection
shared medium::shared medium
single broadcast::single broadcast
thin ethernet::thin ethernet
mbps speed::mbps speed
maximum range::maximum range
segment length::segment length
maximum number::maximum number
total cable::total cable
cable length::cable length
long cable::long cable
signal travels::signal travels
incoming weak::incoming weak
weak signal::weak signal
stronger signal::stronger signal
thick ethernet::thick ethernet
thin net::thin net
simple cable::simple cable
add stations::add stations
small networks::small networks
longer recommended::longer recommended
limited number::limited number
cable slows::cable slows
response rates::response rates
communication channels::communication channels
complete graph::complete graph
point-to-point network::point-to-point network
dedicated link::dedicated link
packet formats::packet formats
total length::total length
previous thin::previous thin
network suppose::network suppose
mesh topology::mesh topology
computer takes::computer takes
takes turns::takes turns
orderly fashion::orderly fashion
division multiplexing::division multiplexing
shared channel::shared channel
star topology::star topology
central hub::central hub
stage mention::stage mention
physical topology::physical topology
logical topology::logical topology
practical utility::practical utility
cable connections::cable connections
central point::central point
long running::long running
loose connections::loose connections
out failures::out failures
bit difficult::bit difficult
physical star::physical star
logical bus::logical bus
important thing::important thing
central node::central node
previous star::previous star
star diagram::star diagram
computers connected::computers connected
utp cables::utp cables
twisted pair::twisted pair
pair cables::pair cables
rj-45 connectors::rj-45 connectors
physical diagram::physical diagram
extended star::extended star
star connection::star connection
hybrid topology::hybrid topology
cable running::cable running
important topology::important topology
ring topology::ring topology
closed loop::closed loop
first node::first node
node passes::node passes
ring ring::ring ring
ring connections::ring connections
past offices::past offices
connector cables::connector cables
wrong side::wrong side
important reason::important reason
broken ring::broken ring
single ring::single ring
fault tolerance::fault tolerance
good reason::good reason
wide area::wide area
telephone exchanges::telephone exchanges
fiber optics::fiber optics
optics cable::optics cable
equal access::equal access
good thing::good thing
data travels::data travels
double ring::double ring
common type::common type
token ring::token ring
ring token::ring token
ieee standard::ieee standard
standard number::standard number
destination data::destination data
transmitting device::transmitting device
empty token::empty token
token passed::token passed
data packet::data packet
final user::final user
destination node::destination node
original sender::original sender
data packets::data packets
packets travel::packets travel
great speed::great speed
synchronous operation::synchronous operation
great speeds::great speeds
find faults::find faults
rectify faults::rectify faults
ordinary cable::ordinary cable
entire ring::entire ring
smaller rings::smaller rings
rings exist::rings exist
exist nowadays::exist nowadays
common topology::common topology
lan technologies::lan technologies
token passing::token passing
synchronized access::synchronized access
shared communication::shared communication
communication medium::communication medium
medium bits::medium bits
bits pass::bits pass
transmitter past::transmitter past
destination hardware::destination hardware
attached computer::attached computer
small technicality::small technicality
sender holding::sender holding
holding token::holding token
token transmits::token transmits
transmits bits::transmits bits
frames computer::frames computer
token passes::token passes
high speed::high speed
destination passes::destination passes
sender receives::sender receives
transmission computer::transmission computer
computer transmits::computer transmits
transmits token::transmits token
computer ready::computer ready
originally part::originally part
lan technology::lan technology
ring devices::ring devices
dominant lan::dominant lan
fddi lived::fddi lived
specific advantage::specific advantage
optic cables::optic cables
cables multi::cables multi
multi mode::multi mode
mode fibers::mode fibers
single mode::single mode
send data::send data
nowadays fddi::nowadays fddi
fddi technology::fddi technology
basic reason::basic reason
inherent fault::inherent fault
tolerance capability::tolerance capability
fault tolerant::fault tolerant
tolerant ring::tolerant ring
ring technology::ring technology
full form::full form
fiber distributed::fiber distributed
distributed data::distributed data
data interconnect::data interconnect
transmits data::transmits data
concentric rings::concentric rings
fault occurs::fault occurs
rings stars::rings stars
fddi switches::fddi switches
switches form::switches form
tree-like structure::tree-like structure
older networks::older networks
older segments::older segments
hybrid kind::hybrid kind
star bus::star bus
star ring::star ring
ring star::ring star
multi-station access::multi-station access
access unit::access unit
full mesh::full mesh
complete mesh::complete mesh
alternative paths::alternative paths
diagram shows::diagram shows
direct path::direct path
indirect paths::indirect paths
links breaks::links breaks
arrangement takes::arrangement takes
takes lot::takes lot
partial mesh::partial mesh
taking care::taking care
passing protocol::passing protocol
interconnect lans::interconnect lans
wan links::wan links
wan link::wan link
wan service::wan service
service providers::service providers
unavailable due::unavailable due
node failure::node failure
link failure::link failure
improves fault::improves fault
increased cost::increased cost
cost installation::cost installation
disadvantages rings::disadvantages rings
rings ease::rings ease
ease synchronization::ease synchronization
cable breaks::cable breaks
breaks star::breaks star
cable bus::cable bus
bus requires::bus requires
fewer cables::fewer cables
reliable bus::reliable bus
fashion extended::fashion extended
area networks::area networks
mesh topologies::mesh topologies
logical topologies::logical topologies
examples suppose::examples suppose
cable ducts::cable ducts
ducts running::ducts running
similar manner::similar manner
central place::central place
topology suppose::topology suppose
cables coming::cables coming
physical duct::physical duct
actual connection::actual connection
data access::data access
transmits packets::transmits packets
revealing cables::revealing cables
cables emerging::cables emerging
network box::network box
connection people::connection people
actual physical::actual physical
network boxes::network boxes
topology min::topology min
min place::min place
cable installation::cable installation
installation network::installation network
network connections::network connections
drill holes::drill holes
first thing::first thing
logical ring::logical ring
cost benefit::cost benefit
greenfield kind::greenfield kind
stable thing::stable thing
topology kind::topology kind
bandwidth capacity::bandwidth capacity
problems ease::problems ease
finding fault::finding fault
important factor::important factor
central cabling::central cabling
cabling plan::cabling plan
easy fault::easy fault
fault finding::fault finding
lecture good::lecture good
users share::users share
total bandwidth::total bandwidth
frequency range::frequency range
valuable resource::valuable resource
transmission services::transmission services
leased lines::leased lines
lines packet::lines packet
packet switched::packet switched
switched networks::switched networks
complex proposition::complex proposition
maximum amount::maximum amount
communication multiplexing::communication multiplexing
compression techniques::compression techniques
techniques save::techniques save
data capacity::data capacity
line increases::line increases
data devices::data devices
modest amount::modest amount
aggregated requirements::aggregated requirements
substantial bandwidth::substantial bandwidth
current technique::current technique
include frequency::include frequency
frequency division::frequency division
wavelength division::wavelength division
code division::code division
physical link::physical link
link .on::link .on
sender receiver::sender receiver
receiver pairs::receiver pairs
direct point::direct point
point connection::point connection
.first problem::.first problem
large amount::large amount
large number::large number
computer side::computer side
older approach::older approach
multi drop::multi drop
drop line::drop line
host polls::host polls
polls machine::polls machine
total communications::total communications
communications load::communications load
multiplexer approach::multiplexer approach
device data::device data
out link::out link
link carries::link carries
carries multiple::carries multiple
multiple channels::multiple channels
noise present::noise present
digital signals::digital signals
resilient compared::resilient compared
analog signals::analog signals
correct errors::correct errors
error checking::error checking
checking information::checking information
sending groups::sending groups
extra byte::extra byte
odd parity::odd parity
receiver end::receiver end
sending station::sending station
odd .in::odd .in
primitive kind::primitive kind
sophisticated error::sophisticated error
checking methods::checking methods
methods employed::methods employed
computer::computer
networks::networks
prof::prof
sujoy::sujoy
ghosh::ghosh
lecture::lecture
network::network
topology::topology
good::good
day::day
discuss::discuss
reference::reference
quick::quick
recap::recap
learnt::learnt
last::last
basically::basically
number::number
nodes::nodes
connected::connected
communication::communication
links::links
kind::kind
call::call
graph::graph
representing::representing
structure::structure
talk::talk
implication::implication
communicate::communicate
general::general
feasible::feasible
one-to-one::one-to-one
pair::pair
node::node
formed::formed
manner::manner
subject::subject
matter::matter
discussion::discussion
today::today
represented::represented
represent::represent
devices::devices
switches::switches
routers::routers
modes::modes
broadcast::broadcast
point::point
first::first
lan::lan
topologies::topologies
local::local
area::area
star::star
ring::ring
bus::bus
simple::simple
based::based
shared::shared
link::link
point-to-point::point-to-point
specifically::specifically
communicating::communicating
short::short
send::send
message::message
ignore::ignore
private::private
sense::sense
copy::copy
purpose::purpose
distributed::distributed
protocol::protocol
decide::decide
communications::communications
collide::collide
medium::medium
pairs::pairs
garbled::garbled
clear::clear
signal::signal
require::require
simplest::simplest
thing::thing
single::single
cable::cable
connects::connects
computers::computers
hanging::hanging
synchronize::synchronize
transmit::transmit
copper::copper
picture::picture
simply::simply
capture::capture
maintained::maintained
segment::segment
end::end
terminator::terminator
happen::happen
sends::sends
reflected::reflected
properly::properly
terminated::terminated
unwanted::unwanted
noise::noise
coaxial::coaxial
two::two
types::types
cables::cables
traditionally::traditionally
thin::thin
thick::thick
extra::extra
stations::stations
added::added
daisy::daisy
chain::chain
technology::technology
sort::sort
outdated::outdated
moment::moment
lans::lans
people::people
moving::moving
out::out
main::main
reason::reason
connection::connection
loose::loose
problem::problem
reasons::reasons
obsolete::obsolete
days::days
machines::machines
sharing::sharing
standard::standard
ieee::ieee
eliminate::eliminate
replace::replace
ethernet::ethernet
10base2::10base2
stands::stands
mbps::mbps
speed::speed
maximum::maximum
range::range
length::length
meters::meters
connections::connections
four::four
repeaters::repeaters
total::total
long::long
travels::travels
line::line
weak::weak
regenerate::regenerate
repeater::repeater
incoming::incoming
amplify::amplify
stronger::stronger
handle::handle
version::version
10base5::10base5
megabits::megabits
backbones::backbones
limited::limited
net::net
advantages::advantages
disadvantages::disadvantages
inexpensive::inexpensive
easy::easy
add::add
punch::punch
station::station
means::means
amount::amount
works::works
small::small
longer::longer
recommended::recommended
parts::parts
fashion::fashion
unreliable::unreliable
reliable::reliable
disadvantage::disadvantage
attached::attached
difficult::difficult
isolate::isolate
problems::problems
slows::slows
response::response
rates::rates
direct::direct
dedicated::dedicated
channels::channels
connect::connect
forms::forms
mesh::mesh
complete::complete
flexibility::flexibility
hardware::hardware
packet::packet
formats::formats
security::security
privacy::privacy
interconnect::interconnect
nc2::nc2
approximately::approximately
equal::equal
involved::involved
increasing::increasing
expensive::expensive
previous::previous
high::high
suppose::suppose
connecting::connecting
issue::issue
ports::ports
provide::provide
alternative::alternative
coming::coming
illustrated::illustrated
buildings::buildings
enormous::enormous
side::side
running::running
lot::lot
reduce::reduce
give::give
idea::idea
directly::directly
necessarily::necessarily
share::share
ways::ways
doing::doing
multiplexing::multiplexing
takes::takes
turns::turns
orderly::orderly
division::division
include::include
technique::technique
synchronizing::synchronizing
channel::channel
wait::wait
turn::turn
34-17.18::34-17.18
common::common
central::central
hub::hub
centre::centre
wheel::wheel
stage::stage
mention::mention
physical::physical
logical::logical
made::made
advantage::advantage
converting::converting
previously::previously
practical::practical
utility::utility
case::case
disconnected::disconnected
bring::bring
centrally::centrally
locate::locate
find::find
failures::failures
bit::bit
maintains::maintains
important::important
diagram::diagram
idealized::idealized
written::written
rj-45::rj-45
connector::connector
ubiquitous::ubiquitous
telephones::telephones
utp::utp
unshielded::unshielded
twisted::twisted
easier::easier
cheaper::cheaper
connectors::connectors
sides::sides
extended::extended
stars::stars
hubs::hubs
switch::switch
50-21::50-21
hybrid::hybrid
part::part
leaving::leaving
closed::closed
loop::loop
passes::passes
data::data
hopping::hopping
reaches::reaches
destination::destination
surely::surely
reach::reach
practice::practice
run::run
past::past
offices::offices
sockets::sockets
rings::rings
direction::direction
wrong::wrong
put::put
putting::putting
failure::failure
possibility::possibility
wrap::wrap
physically::physically
broken::broken
breakage::breakage
break::break
fail::fail
things::things
fault::fault
tolerance::tolerance
wide::wide
telephone::telephone
exchanges::exchanges
fiber::fiber
optics::optics
talking::talking
cut::cut
place::place
trick::trick
shown::shown
summary::summary
characteristics::characteristics
beginning::beginning
access::access
media::media
double::double
device::device
start::start
transmitting::transmitting
type::type
token::token
extracted::extracted
acknowledgement::acknowledgement
receipt::receipt
back::back
removed::removed
empty::empty
passed::passed
make::make
final::final
user::user
identification::identification
bunch::bunch
meant::meant
extract::extract
original::original
sender::sender
received::received
remove::remove
circulating::circulating
.as::.as
packets::packets
travel::travel
great::great
synchronous::synchronous
operation::operation
remember::remember
actions::actions
killing::killing
synchronized::synchronized
synchronization::synchronization
speeds::speeds
collisions::collisions
faults::faults
rectify::rectify
terminators::terminators
required::required
ordinary::ordinary
requires::requires
couple::couple
breakdowns::breakdowns
entire::entire
smaller::smaller
exist::exist
nowadays::nowadays
concerned::concerned
fact::fact
technologies::technologies
passing::passing
treated::treated
bits::bits
pass::pass
transmitter::transmitter
copied::copied
designed::designed
commission::commission
technicality::technicality
interface::interface
function::function
independently::independently
nice::nice
shut::shut
affected::affected
holding::holding
transmits::transmits
frames::frames
circulate::circulate
makes::makes
receives::receives
frame::frame
work::work
waits::waits
transmission::transmission
ready::ready
originally::originally
fell::fell
disuse::disuse
costly::costly
dominant::dominant
fddi::fddi
lived::lived
due::due
specific::specific
optic::optic
multi::multi
mode::mode
fibers::fibers
fairly::fairly
comparable::comparable
level::level
aging::aging
sound::sound
proposed::proposed
basic::basic
inherent::inherent
capability::capability
tolerant::tolerant
extensively::extensively
wan::wan
full::full
form::form
order::order
magnitude::magnitude
concentric::concentric
occurs::occurs
automatically::automatically
disturbed::disturbed
emanates::emanates
configured::configured
tree-like::tree-like
older::older
updated::updated
replaced::replaced
segments::segments
combines::combines
mau::mau
multi-station::multi-station
unit::unit
study::study
discussed::discussed
earlier::earlier
paths::paths
shows::shows
path::path
indirect::indirect
source::source
breaks::breaks
arrangement::arrangement
partial::partial
dropped::dropped
taking::taking
care::care
redundancy::redundancy
evolve::evolve
method::method
sensing::sensing
correcting::correcting
complicated::complicated
places::places
wans::wans
users::users
naturally::naturally
expect::expect
grade::grade
service::service
providers::providers
unavailable::unavailable
traffic::traffic
pros::pros
cons::cons
improves::improves
carry::carry
increased::increased
cost::cost
installation::installation
difficulty::difficulty
management::management
troubleshooting::troubleshooting
ease::ease
disabled::disabled
manage::manage
robust::robust
fewer::fewer
gravitating::gravitating
emerging::emerging
21-46::21-46
examples::examples
ducts::ducts
similar::similar
essentially::essentially
similarly::similarly
duct::duct
actual::actual
revealing::revealing
piece::piece
box::box
replaces::replaces
depending::depending
choice::choice
affect::affect
dictate::dictate
depend::depend
boxes::boxes
design::design
carefully::carefully
change::change
designing::designing
min::min
correct::correct
determine::determine
protocols::protocols
spots::spots
drill::drill
holes::holes
building::building
factors::factors
account::account
deciding::deciding
kinds::kinds
factor::factor
benefit::benefit
greenfield::greenfield
situation::situation
significant::significant
question::question
scalability::scalability
choked::choked
bandwidth::bandwidth
join::join
happening::happening
stable::stable
organization::organization
years::years
scale::scale
capacity::capacity
install::install
finding::finding
class::class
cabling::cabling
plan::plan
.there::.there
standards::standards
structured::structured
maintenance::maintenance
preview::preview
signals::signals
interfere::interfere
.for::.for
multiple::multiple
divided::divided
portion::portion
frequency::frequency
valuable::valuable
resource::resource
facilitate::facilitate
senders::senders
receivers.that::receivers.that
chief::chief
services::services
leased::leased
lines::lines
switched::switched
laying::laying
complex::complex
proposition::proposition
lay::lay
utilize::utilize
compression::compression
techniques::techniques
save::save
money::money
business::business
increases::increases
effective::effective
company::company
.most::.most
individually::individually
modest::modest
aggregated::aggregated
requirements::requirements
occupy::occupy
substantial::substantial
current::current
accomplish::accomplish
wavelength::wavelength
code::code
scheme::scheme
multiplexer::multiplexer
inputs::inputs
.so::.so
mixed::mixed
.on::.on
separated::separated
recipients::recipients
left::left
receivers::receivers
receiver::receiver
utilizing::utilizing
.first::.first
large::large
wiring::wiring
floors::floors
hundreds::hundreds
.that::.that
bottleneck::bottleneck
approach::approach
drop::drop
host::host
polls::polls
machine::machine
load::load
greater::greater
rate::rate
multiplexed::multiplexed
carries::carries
information::information
restored::restored
quantum::quantum
present::present
.if::.if
lose::lose
distortion::distortion
loss::loss
digital::digital
resilient::resilient
compared::compared
analog::analog
errors::errors
bytes::bytes
error::error
checking::checking
retransmission::retransmission
detected::detected
sending::sending
groups::groups
byte::byte
odd::odd
parity::parity
flipped::flipped
happened::happened
supposed::supposed
adding::adding
.in::.in
request::request
retransmit::retransmit
primitive::primitive
sophisticated::sophisticated
methods::methods
employed::employed
