computer networks prof::computer networks prof
networks prof sujoy::networks prof sujoy
prof sujoy ghosh::prof sujoy ghosh
sujoy ghosh dept::sujoy ghosh dept
dept of computer::dept of computer
science and engineering::science and engineering
iit kharagpur lecture::iit kharagpur lecture
day so today::day so today
talking about switches::talking about switches
types of switches::types of switches
kind of switches::kind of switches
talking about packet::talking about packet
heart of data::heart of data
networks first thing::networks first thing
order n2 kind::order n2 kind
kind of lines::kind of lines
user is connected::user is connected
essentially a switch::essentially a switch
switching office switches::switching office switches
office switches establish::office switches establish
switches establish temporary::switches establish temporary
establish temporary circuits::establish temporary circuits
means they establish::means they establish
establish a temporary::establish a temporary
switching station switching::switching station switching
station switching systems::station switching systems
discussion about telecom::discussion about telecom
station the switching::station the switching
making this connection::making this connection
kind of computers::kind of computers
capable of sending::capable of sending
sending some kind::sending some kind
kind of signals::kind of signals
signals or instructions::signals or instructions
switch for setting::switch for setting
plane is sort::plane is sort
connection is set::connection is set
naturally the call::naturally the call
close to switching::close to switching
decide about long-range::decide about long-range
seven-layer osi protocols::seven-layer osi protocols
layer whose job::layer whose job
order to reach::order to reach
reach the ultimate::reach the ultimate
ultimate destination station::ultimate destination station
strictly a local::strictly a local
coming from input::coming from input
routers to reach::routers to reach
reach my destination::reach my destination
switch the job::switch the job
signal is coming::signal is coming
required routing static::required routing static
routing static routing::routing static routing
means same destination::means same destination
destination is routed::destination is routed
depending on traffic::depending on traffic
means some part::means some part
avoid that path::avoid that path
distribute the telephone::distribute the telephone
numbers to subscribers::numbers to subscribers
easy to route::easy to route
connectivity between input::connectivity between input
input and output::input and output
discuss some basic::discuss some basic
concepts and terminology::concepts and terminology
medium ? transfer::medium ? transfer
send a stream::send a stream
stream of cells::stream of cells
queues are memory::queues are memory
temporarily store cells::temporarily store cells
store cells switches::store cells switches
switches often require::switches often require
require some queues::require some queues
side ; queues::side ; queues
temporary memory locations::temporary memory locations
store some cells::store some cells
destination a switching::destination a switching
switch a switch::switch a switch
point a switch::point a switch
switch may connect::switch may connect
elements these switching::elements these switching
switching elements form::switching elements form
form the so-called::form the so-called
means the shape::means the shape
switches are organized::switches are organized
term called blocking::term called blocking
blocking and non-blocking::blocking and non-blocking
means a network::means a network
network is unable::network is unable
unable to connect::unable to connect
calls the point::calls the point
thousands of subscribers::thousands of subscribers
provide the switching::provide the switching
maximum possible extent::maximum possible extent
provision our equipment::provision our equipment
people have done::people have done
made an extensive::made an extensive
labs in usa::labs in usa
giant telephone company::giant telephone company
study about people::study about people
habits they found::habits they found
officers are open::officers are open
kind of statistic::kind of statistic
statistic they collected::statistic they collected
person starts talking::person starts talking
line they found::line they found
found the statistical::found the statistical
elements and switching::elements and switching
exceptions may occur::exceptions may occur
number of subscribers::number of subscribers
subscribers who wanted::subscribers who wanted
wanted to speak::wanted to speak
talking in terms::talking in terms
terms of switching::terms of switching
capacity this kind::capacity this kind
kind of blocking::kind of blocking
blocking may occur::blocking may occur
capacity to handle::capacity to handle
calculate the blocking::calculate the blocking
permits all stations::permits all stations
stations to connect::stations to connect
connect in pairs::connect in pairs
connection where blocking::connection where blocking
allowed or blocking::allowed or blocking
amount of blocking::amount of blocking
degree of blocking::degree of blocking
kinds of switches::kinds of switches
switches neatly fit::switches neatly fit
hybrid or mixture::hybrid or mixture
space division switching::space division switching
multiplexing and frequency::multiplexing and frequency
frequency division multiplexing::frequency division multiplexing
switching time division::switching time division
space division switches::space division switches
stage or multistage::stage or multistage
multistage in single::multistage in single
shuffle exchange networks::shuffle exchange networks
networks in multistage::networks in multistage
path or multipath::path or multipath
multipath like delta::multipath like delta
networks or benes::networks or benes
memory and shared::memory and shared
shared medium shared::shared medium shared
medium shared memory::medium shared memory
memory or shared::memory or shared
talk about space::talk about space
separate physical paths::separate physical paths
unlike time division::unlike time division
discuss time division::discuss time division
paths the simplest::paths the simplest
simplest of space::simplest of space
cross bar switch::cross bar switch
switch the number::switch the number
number of cross::number of cross
cross points grows::cross points grows
square of number::square of number
number of stations::number of stations
stations ; loss::stations ; loss
loss of cross::loss of cross
cross point prevents::cross point prevents
point prevents connection::point prevents connection
point becomes bad::point becomes bad
stations are connected::stations are connected
switch a cross::switch a cross
input lines coming::input lines coming
fourth input line::fourth input line
direct physical path::direct physical path
single switching element::single switching element
n cross points::-NONE- cross points
switches one good::switches one good
kind of switch::kind of switch
pairs of subscribers::pairs of subscribers
subscribers can talk::subscribers can talk
lines that feed::lines that feed
feed to n2electronic::feed to n2electronic
lines are full::lines are full
means all lines::means all lines
lines allow communication::lines allow communication
half the number::half the number
number of switches::number of switches
require the diagonal::require the diagonal
switches ? top::switches ? top
top half means::top half means
half means top::half means top
means top half::means top half
switches are required::switches are required
full duplex lines::full duplex lines
cross bar switches::cross bar switches
problem ? people::problem ? people
design for switches::design for switches
at&t bell labs::at&t bell labs
essentially we require::essentially we require
require using output::require using output
issues in detail::issues in detail
number of bits::number of bits
line can handle::line can handle
speed transfer medium::speed transfer medium
transfer medium consists::transfer medium consists
inlet n bus::inlet n bus
bus interface units::bus interface units
buses each delivers::buses each delivers
delivers an output::delivers an output
side a call::side a call
call to subscriber::call to subscriber
broadcast the signal::broadcast the signal
units are connected::units are connected
receive that signal::receive that signal
bus interface unit::bus interface unit
supposed be meant::supposed be meant
signal to transfer::signal to transfer
fairly simple scheme::fairly simple scheme
reduced the number::reduced the number
number of switching::number of switching
switches and multistage::switches and multistage
commonly used switching::commonly used switching
architecture even today::architecture even today
division is concerned::division is concerned
concerned in multistage::concerned in multistage
provision less number::provision less number
reduce the cost::reduce the cost
simple cross bar::simple cross bar
switch is bad::switch is bad
pair of users::pair of users
element becomes bad::element becomes bad
communicate the control::communicate the control
number of inlets::number of inlets
inlets and outlets::inlets and outlets
grouped into small::grouped into small
problems with pins::problems with pins
pins and input::pins and input
identical switching building::identical switching building
switching building blocks::switching building blocks
forming a fabric::forming a fabric
building blocks consisting::building blocks consisting
stages the input::stages the input
stage is broken::stage is broken
modules these modules::modules these modules
sort of cheaper::sort of cheaper
cheaper to manufacture::cheaper to manufacture
building blocks forming::building blocks forming
fabric has multiple::fabric has multiple
small multistage interconnection::small multistage interconnection
multistage interconnection network::multistage interconnection network
sort of switch::sort of switch
kind of system::kind of system
line ? suppose::line ? suppose
suppose the output::suppose the output
lines are numbered::lines are numbered
input line number::input line number
output line number::output line number
lower output line::lower output line
upper output line::upper output line
binary number order::binary number order
maintaining the switch::maintaining the switch
simply a rule::simply a rule
routing is easy::routing is easy
multistage interconnection networks::multistage interconnection networks
constructed of identical::constructed of identical
regular interconnection patterns::regular interconnection patterns
interconnection patterns suitable::interconnection patterns suitable
large-scale chip integration::large-scale chip integration
log_k n number::log_k n number
number of digits::number of digits
log-k n number::log-k n number
number of stages::number of stages
bigger delta network::bigger delta network
order to code::order to code
require four bits::require four bits
regular cross bar::regular cross bar
require some thing::require some thing
problem of contention::problem of contention
delta network cells::delta network cells
network however cells::network however cells
similarly another line::similarly another line
two different points::two different points
sort of converging::sort of converging
make it wait::make it wait
wait by putting::wait by putting
blocked or dropped::blocked or dropped
contention some ways::contention some ways
ways to reduce::ways to reduce
basic switching element::basic switching element
increase the internal::increase the internal
internal link speed::internal link speed
link speed relative::link speed relative
sort of techniques::sort of techniques
techniques to reduce::techniques to reduce
speed that means::speed that means
streams are concerned::streams are concerned
notice the faster::notice the faster
contention then give::contention then give
sort of re-circulates::sort of re-circulates
networks in parallel::networks in parallel
parallel ; provide::parallel ; provide
provide multiple links::provide multiple links
internally between switching::internally between switching
batcher banyan switch::batcher banyan switch
banyan switch part::banyan switch part
collide by contending::collide by contending
space division switch::space division switch
switch is broken::switch is broken
broken into multistage::broken into multistage
multistage smaller chunks::multistage smaller chunks
show a three-stage::show a three-stage
three-stage switch suppose::three-stage switch suppose
switch ; suppose::switch ; suppose
reduces the number::reduces the number
cross bar kind::cross bar kind
reduce the number::reduce the number
switch can handle::switch can handle
telephone company makes::telephone company makes
makes a good::makes a good
study and finds::study and finds
low blocking probability::low blocking probability
multistage interconnect network::multistage interconnect network
connection based kind::connection based kind
connection is made::connection is made
call is held::call is held
usual telephone network::usual telephone network
stream of bits::stream of bits
bits is divided::bits is divided
divided into small::divided into small
main many connections::main many connections
switch ? cell-based::switch ? cell-based
cell-based means routing::cell-based means routing
means routing tag::means routing tag
routing tag versus::routing tag versus
tag versus network-based::tag versus network-based
change in routing::change in routing
encoding the input::encoding the input
specifically the output::specifically the output
cell can route::cell can route
kind of code::kind of code
call it tag::call it tag
tag this tag::tag this tag
shown in delta::shown in delta
kind of tag::kind of tag
table to find::table to find
augmented to include::augmented to include
include extra header::include extra header
extra header information::extra header information
enter a switch::enter a switch
switch that means::switch that means
add the code::add the code
siemens atm chip::siemens atm chip
atm chip set::atm chip set
octet or byte::octet or byte
cell is augmented::cell is augmented
enters the switch::enters the switch
extra information speeds::extra information speeds
discussed this earlier::discussed this earlier
path is determined::path is determined
connection that means::connection that means
connection the path::connection the path
system with cells::system with cells
path is designated::path is designated
path this guarantees::path this guarantees
guarantees proper sequencing::guarantees proper sequencing
sequencing of cells::sequencing of cells
order the connection::order the connection
connection you find::connection you find
combination of random::combination of random
selection to distribute::selection to distribute
distribute the load::distribute the load
path is loaded::path is loaded
route your path::route your path
paths to distribute::paths to distribute
selection to arrive::selection to arrive
types of switching::types of switching
connections plus tags::connections plus tags
discuss packet switches::discuss packet switches
connectionless plus tables::connectionless plus tables
costly in terms::costly in terms
kind of speed::kind of speed
lookup becomes limited::lookup becomes limited
systems using tables::systems using tables
packet switches buffers::packet switches buffers
utilization of memory::utilization of memory
bursts of equal::bursts of equal
equal loads complete::equal loads complete
loads complete sharing::loads complete sharing
complete sharing means::complete sharing means
central memory kind::central memory kind
kind of thing::kind of thing
naturally complete partitioning::naturally complete partitioning
unbalanced load partial::unbalanced load partial
load partial sharing::load partial sharing
partial sharing means::partial sharing means
strategies regarding buffers::strategies regarding buffers
division switches follow::division switches follow
specific time slot::specific time slot
round robin fashion::round robin fashion
switches the bits::switches the bits
bits or bit::bits or bit
streams may follow::streams may follow
line is read::line is read
ram in order::ram in order
constitutes a single::constitutes a single
frame that means::frame that means
means a fixed::means a fixed
line a mapping::line a mapping
mapping table reads::mapping table reads
order for switching::order for switching
switching from line::switching from line
location is read::location is read
output is read::output is read
read by line::read by line
slot so line::slot so line
connected to line::connected to line
switched to line::switched to line
dedicated internal buffer::dedicated internal buffer
internal buffer memory::internal buffer memory
code and data::code and data
buffer will sort::buffer will sort
completely separate physical::completely separate physical
separate physical module::separate physical module
printed writing card::printed writing card
two dma bidirectional::two dma bidirectional
dma bidirectional serial::dma bidirectional serial
bidirectional serial ports::bidirectional serial ports
studied operating system::studied operating system
direct memory access::direct memory access
intervention of cpu::intervention of cpu
port with dedicated::port with dedicated
multiple port memories::multiple port memories
memories and serial::memories and serial
simplified block diagram::simplified block diagram
serial to parallel::serial to parallel
bits and converting::bits and converting
fed in parallel::fed in parallel
parallel so database::parallel so database
buffer ram memory::buffer ram memory
consecutive address generated::consecutive address generated
parallel to serial::parallel to serial
converter for feeding::converter for feeding
list or table::list or table
table for mapping::table for mapping
input time slots::input time slots
slots to output::slots to output
output time slots::output time slots
call is set::call is set
make an increase::make an increase
memory the pointer::memory the pointer
pointer data values::pointer data values
values are set::values are set
basis the data::basis the data
address to access::address to access
access the buffer::access the buffer
ram ; decimal::ram ; decimal
representation is shown::representation is shown
pointer or content::pointer or content
means line number::means line number
connected into line::connected into line
byte is read::byte is read
seconds you remember::seconds you remember
remember we talked::remember we talked
voice channel requires::voice channel requires
requires a capacity::requires a capacity
entire time division::entire time division
sort of sticks::sort of sticks
higher speed channel::higher speed channel
seconds ? slot::seconds ? slot
write so 2nt::write so 2nt
switch will require::switch will require
require a cycle::require a cycle
kind of memory::kind of memory
number of lines::number of lines
speed of switches::speed of switches
space to division::space to division
device multistage switches::device multistage switches
point about capacity::point about capacity
average call arrival::average call arrival
call arrival rate::call arrival rate
distribution as people::distribution as people
seconds per call::seconds per call
distribution the call::distribution the call
load in erlangs::load in erlangs
allocate a channel::allocate a channel
call blocking probability::call blocking probability
achieve the difference::achieve the difference
formula for calculating::formula for calculating
write a small::write a small
formula to calculate::formula to calculate
calculate the call::calculate the call
blocking probability giving::blocking probability giving
probability giving values::probability giving values
last this thing::last this thing
thing ? verify::thing ? verify
verify using erlang-b::verify using erlang-b
erlang-b and stirlings::erlang-b and stirlings
approximation for handling::approximation for handling
handling the factorial::handling the factorial
average channel utilization::average channel utilization
small blocking probability::small blocking probability
discuss about packet::discuss about packet
switches that means::switches that means
means packet switches::means packet switches
switches are switches::switches are switches
designed for handling::designed for handling
switches like space::switches like space
division time division::division time division
switches the performance::switches the performance
enhanced by moving::enhanced by moving
switched lans moving::switched lans moving
kinds of lans::kinds of lans
two nodes connected::two nodes connected
lan can communicate::lan can communicate
switch multiple pairs::switch multiple pairs
pairs of users::pairs of users
users or multiple::users or multiple
pairs of nodes::pairs of nodes
nodes can communicate::nodes can communicate
boost in performance::boost in performance
multiple distinct source::multiple distinct source
distinct source destination::distinct source destination
source destination pairs::source destination pairs
require a switch::require a switch
networks a packet::networks a packet
packet to find::packet to find
find the destination::find the destination
full scale sort::full scale sort
sort of lookup::sort of lookup
cell to outgoing::cell to outgoing
outgoing interface transmit::outgoing interface transmit
interface transmit cell::interface transmit cell
cell onto link::cell onto link
out the output::out the output
output the address::output the address
simply a small::simply a small
makes this lookup::makes this lookup
process much faster::process much faster
develop your hardware::develop your hardware
switches will work::switches will work
switching principle remains::switching principle remains
common most common::common most common
type of switch::type of switch
matter of fact::matter of fact
fact this number::fact this number
number of ethernet::number of ethernet
hare being put::hare being put
amountize the cost::amountize the cost
cheap these days::cheap these days
days ok switch::days ok switch
ten fifteen years::ten fifteen years
thousand rupees today::thousand rupees today
computer networks::computer networks
networks prof::networks prof
prof sujoy::prof sujoy
sujoy ghosh::sujoy ghosh
ghosh dept::ghosh dept
computer science::computer science
iit kharagpur::iit kharagpur
kharagpur lecture::kharagpur lecture
good day::good day
switches switches::switches switches
important part::important part
telecom networks::telecom networks
special version::special version
packet switches::packet switches
data networks::data networks
telephone networks::telephone networks
direct lines::direct lines
switching office::switching office
office switches::office switches
establish temporary::establish temporary
temporary circuits::temporary circuits
temporary connection::temporary connection
switching station::switching station
station switching::station switching
switching systems::switching systems
switch controller::switch controller
switching stations::switching stations
control plane::control plane
control planes::control planes
individual switches::individual switches
end-to-end connection::end-to-end connection
overlay network::overlay network
actual switch::actual switch
network device::network device
long-range paths::long-range paths
seven-layer osi::seven-layer osi
osi protocols::osi protocols
network layer::network layer
ultimate destination::ultimate destination
destination station::destination station
local link::local link
local decision::local decision
global implication::global implication
output side::output side
signal coming::signal coming
input line::input line
incoming link::incoming link
outgoing link::outgoing link
added functionality::added functionality
required routing::required routing
static routing::static routing
dynamic routing::dynamic routing
routing depending::routing depending
telephone numbers::telephone numbers
incoming digits::incoming digits
route switching::route switching
local connectivity::local connectivity
output lines::output lines
basic concepts::basic concepts
transfer medium::transfer medium
electronic buses::electronic buses
cells queues::cells queues
memory locations::memory locations
store cells::store cells
cells switches::cells switches
input side::input side
temporary memory::temporary memory
switching element::switching element
building block::building block
simple element::simple element
big switch::big switch
switching elements::switching elements
elements form::elements form
incoming calls::incoming calls
blocking means::blocking means
connect stations::connect stations
blocking network::blocking network
voice systems::voice systems
main reason::main reason
short-duration calls::short-duration calls
switching capability::switching capability
busy talking::busy talking
equipment based::equipment based
telephone people::telephone people
extensive study::extensive study
giant telephone::giant telephone
telephone company::telephone company
early part::early part
calling habits::calling habits
peak hour::peak hour
subscriber base::subscriber base
person starts::person starts
call duration::call duration
statistical distribution::statistical distribution
switching capacity::switching capacity
statistical study::statistical study
provision based::provision based
statistical averages::statistical averages
exceptional times::exceptional times
short durations::short durations
blocking probability::blocking probability
nowadays people::nowadays people
non-blocking permits::non-blocking permits
data connection::data connection
limited amount::limited amount
high degree::high degree
actual switches::actual switches
space division::space division
division switching::division switching
division multiplexing::division multiplexing
frequency division::frequency division
division switches::division switches
single stage::single stage
switching matrix::switching matrix
knockout network::knockout network
shuffle exchange::shuffle exchange
exchange networks::exchange networks
single path::single path
delta networks::delta networks
benes networks::benes networks
sorting networks::sorting networks
shared memory::shared memory
shared medium::shared medium
medium shared::medium shared
central memory::central memory
common types::common types
analog environment::analog environment
separate physical::separate physical
physical paths::physical paths
physical path::physical path
cross bar::cross bar
bar switch::bar switch
cross points::cross points
points grows::points grows
cross point::cross point
point prevents::point prevents
prevents connection::prevents connection
fully non-blocking::fully non-blocking
input lines::input lines
lines coming::lines coming
output line::output line
fourth input::fourth input
direct physical::direct physical
single switching::single switching
lines i.e::lines i.e
crossing point::crossing point
poor utilization::poor utilization
good thing::good thing
simplest form::simplest form
n2electronic switches::n2electronic switches
full duplex::full duplex
diagonal switches::diagonal switches
top half::top half
bottom half::bottom half
half means::half means
principal diagonal::principal diagonal
duplex lines::duplex lines
bar switches::bar switches
line switches::line switches
incoming lines::incoming lines
outgoing lines::outgoing lines
sophisticated design::sophisticated design
input queuing::input queuing
output queuing::output queuing
central queuing::central queuing
knockout switches::knockout switches
at&t bell::at&t bell
bell labs::bell labs
output ports::output ports
outlets operate::outlets operate
speed transfer::speed transfer
medium consists::medium consists
broadcast buses::broadcast buses
bus interface::bus interface
interface units::interface units
takes input::takes input
interface unit::interface unit
simple scheme::simple scheme
fast switching::fast switching
knockout switch::knockout switch
buses inside::buses inside
technically feasible::technically feasible
multistage switches::multistage switches
switching architecture::switching architecture
multistage switch::multistage switch
reduced number::reduced number
increases reliability::increases reliability
simple cross::simple cross
large number::large number
small groups::small groups
switching building::switching building
building blocks::building blocks
blocks consisting::blocks consisting
multiple stages::multiple stages
small modules::small modules
identical switching::identical switching
blocks forming::blocks forming
small multistage::small multistage
multistage interconnection::multistage interconnection
interconnection network::interconnection network
small blocks::small blocks
blocking kind::blocking kind
binary fashion::binary fashion
line number::line number
control signals::control signals
lower output::lower output
upper output::upper output
binary number::binary number
number order::number order
upper line::upper line
lower line::lower line
delta network::delta network
interconnection networks::interconnection networks
regular interconnection::regular interconnection
interconnection patterns::interconnection patterns
large-scale chip::large-scale chip
chip integration::chip integration
requiring log_k::requiring log_k
bigger delta::bigger delta
four-stage switch::four-stage switch
bit decides::bit decides
switch connects::switch connects
banyan network::banyan network
multistage fashion::multistage fashion
regular cross::regular cross
network cells::network cells
earlier diagram::earlier diagram
reduce contention::reduce contention
provide buffers::provide buffers
basic switching::basic switching
internal link::internal link
link speed::link speed
external speed::external speed
backward feedback::backward feedback
providing buffers::providing buffers
input streams::input streams
output streams::output streams
multiple networks::multiple networks
multiple links::multiple links
shuffle cells::shuffle cells
batcher banyan::batcher banyan
banyan switch::banyan switch
switch part::switch part
batcher part::batcher part
input cells::input cells
banyan part::banyan part
division switch::division switch
smaller chunks::smaller chunks
three-stage switch::three-stage switch
switch suppose::switch suppose
first stage::first stage
input stage::input stage
switching fabric::switching fabric
general case::general case
bar kind::bar kind
fashion taking::fashion taking
simultaneous calls::simultaneous calls
lying idle::lying idle
company makes::company makes
good study::good study
maximum number::maximum number
low blocking::low blocking
busy hour::busy hour
general scheme::general scheme
lines fitting::lines fitting
switch modules::switch modules
last stage::last stage
multistage interconnect::multistage interconnect
interconnect network::interconnect network
connection based::connection based
based kind::based kind
usual telephone::usual telephone
telephone network::telephone network
user sort::user sort
small cells::small cells
cell-based means::cell-based means
means routing::means routing
routing tag::routing tag
tag versus::tag versus
routing tables::routing tables
extra header::extra header
header information::header information
siemens atm::siemens atm
atm chip::atm chip
chip set::chip set
53-byte octet::53-byte octet
byte cell::byte cell
64-byte cell::64-byte cell
extra bytes::extra bytes
extra information::extra information
information speeds::information speeds
routing process::routing process
connection-based system::connection-based system
entire duration::entire duration
path remains::path remains
connection follow::connection follow
guarantees proper::guarantees proper
intermediate stage::intermediate stage
refused paths::refused paths
random selection::random selection
careful selection::careful selection
correct destination::correct destination
step-by-step fashion::step-by-step fashion
connectionless switches::connectionless switches
discuss packet::discuss packet
table lookup::table lookup
connections-oriented system::connections-oriented system
connectionless systems::connectionless systems
routers specially::routers specially
switches buffers::switches buffers
complete sharing::complete sharing
equal loads::equal loads
sharing means::sharing means
memory kind::memory kind
complete partitioning::complete partitioning
unbalanced load::unbalanced load
partial sharing::partial sharing
switches follow::switches follow
round robin::round robin
robin fashion::robin fashion
bit streams::bit streams
single frame::single frame
fixed number::fixed number
mapping table::mapping table
table reads::table reads
bidirectional communication::bidirectional communication
duplex communication::duplex communication
first slot::first slot
basic components::basic components
tdm switch::tdm switch
internal buffer::internal buffer
buffer memory::buffer memory
ram memory::ram memory
program code::program code
physical module::physical module
writing card::writing card
bidirectional serial::bidirectional serial
serial ports::serial ports
operating system::operating system
direct memory::direct memory
memory access::memory access
fast communication::fast communication
dedicated hardware::dedicated hardware
multiple port::multiple port
port memories::port memories
simplified block::simplified block
block diagram::block diagram
bit stream::bit stream
parallel converter::parallel converter
buffer ram::buffer ram
connection memory::connection memory
make entries::make entries
consecutive address::consecutive address
address generated::address generated
serial converter::serial converter
individual lines::individual lines
data bus::data bus
address bus::address bus
mapping input::mapping input
pointer data::pointer data
data values::data values
call basis::call basis
data output::data output
decimal representation::decimal representation
means line::means line
micro seconds::micro seconds
voice channel::voice channel
channel requires::channel requires
kbps means::kbps means
division hierarchy::division hierarchy
sacred figure::sacred figure
voice call::voice call
higher speed::higher speed
speed channel::speed channel
frame size::frame size
memory cycle::memory cycle
line switch::line switch
memory speed::memory speed
device multistage::device multistage
last point::last point
capacity allocation::capacity allocation
service providers::service providers
stage switch::stage switch
average call::average call
call arrival::call arrival
arrival rate::arrival rate
exponential distribution::exponential distribution
voice network::voice network
data network::data network
average holding::average holding
poisson distribution::poisson distribution
call load::call load
channel capacity::channel capacity
call blocking::call blocking
acceptable level::acceptable level
typical figure::typical figure
small program::small program
probability giving::probability giving
giving values::giving values
stirlings approximation::stirlings approximation
average channel::average channel
channel utilization::channel utilization
channel probability::channel probability
means packet::means packet
handling packets::handling packets
telecom switches::telecom switches
require switches::require switches
switched lans::switched lans
lans moving::lans moving
earliest kinds::earliest kinds
nodes connected::nodes connected
switch multiple::switch multiple
multiple pairs::multiple pairs
good boost::good boost
multiple distinct::multiple distinct
distinct source::distinct source
source destination::source destination
destination pairs::destination pairs
packet networks::packet networks
packet switch::packet switch
destination address::destination address
full scale::full scale
scale sort::scale sort
big table::big table
small table::small table
table replace::table replace
virtual connection::virtual connection
outgoing interface::outgoing interface
interface transmit::interface transmit
transmit cell::transmit cell
switch works::switch works
basic concept::basic concept
cell remains::cell remains
output port::output port
lookup process::lookup process
switching principle::switching principle
principle remains::principle remains
ethernet switch::ethernet switch
common type::common type
ethernet switches::ethernet switches
fifteen years::fifteen years
thousand rupees::thousand rupees
rupees today::rupees today
computer::computer
networks::networks
prof::prof
sujoy::sujoy
ghosh::ghosh
dept::dept
science::science
engineering::engineering
iit::iit
kharagpur::kharagpur
lecture::lecture
switches-1::switches-1
reference::reference
good::good
day::day
today::today
talking::talking
switches::switches
important::important
part::part
aspects::aspects
types::types
kind::kind
telecom::telecom
special::special
version::version
cover::cover
packet::packet
closer::closer
heart::heart
data::data
first::first
thing::thing
problem::problem
user::user
potentially::potentially
call::call
telephone::telephone
direct::direct
lines::lines
order::order
connected::connected
essentially::essentially
switch::switch
switching::switching
office::office
establish::establish
temporary::temporary
circuits::circuits
means::means
connection::connection
caller::caller
callee::callee
station::station
systems::systems
two::two
parts::parts
controller::controller
remember::remember
discussion::discussion
people::people
talk::talk
subscribers::subscribers
location::location
stations::stations
connect::connect
making::making
signaling::signaling
talked::talked
control::control
plane::plane
planes::planes
computers::computers
capable::capable
sending::sending
signals::signals
instructions::instructions
individual::individual
set::set
path::path
signal::signal
setting::setting
circuit::circuit
end-to-end::end-to-end
sort::sort
overlay::overlay
network::network
actual::actual
naturally::naturally
flow::flow
device::device
router::router
routing::routing
close::close
decide::decide
long-range::long-range
paths::paths
seven-layer::seven-layer
osi::osi
protocols::protocols
layer::layer
job::job
find::find
out::out
reach::reach
ultimate::ultimate
destination::destination
local::local
link::link
slightly::slightly
simpler::simpler
strictly::strictly
decision::decision
global::global
implication::implication
output::output
side::side
coming::coming
input::input
line::line
finally::finally
connections::connections
routers::routers
sense::sense
incoming::incoming
outgoing::outgoing
added::added
functionality::functionality
required::required
static::static
approach::approach
routed::routed
dynamic::dynamic
depending::depending
traffic::traffic
congested::congested
avoid::avoid
distribute::distribute
numbers::numbers
easy::easy
route::route
digits::digits
connectivity::connectivity
discuss::discuss
basic::basic
concepts::concepts
terminology::terminology
transfer::transfer
medium::medium
buses::buses
electronic::electronic
send::send
stream::stream
cells::cells
queues::queues
memory::memory
locations::locations
temporarily::temporarily
store::store
require::require
places::places
cases::cases
forward::forward
element::element
building::building
block::block
point::point
simple::simple
big::big
lot::lot
elements::elements
form::form
so-called::so-called
fabric::fabric
shape::shape
organized::organized
calls::calls
handled::handled
term::term
blocking::blocking
non-blocking::non-blocking
unable::unable
voice::voice
main::main
reason::reason
short-duration::short-duration
thousands::thousands
provide::provide
capability::capability
maximum::maximum
extent::extent
busy::busy
subscriber::subscriber
provision::provision
equipment::equipment
based::based
assumption::assumption
expensive::expensive
done::done
made::made
extensive::extensive
study::study
bell::bell
labs::labs
usa::usa
pioneers::pioneers
giant::giant
company::company
largest::largest
broken::broken
early::early
1940s::1940s
1950s::1950s
calling::calling
habits::habits
found::found
peak::peak
hour::hour
officers::officers
open::open
base::base
statistic::statistic
collected::collected
person::person
starts::starts
distribution::distribution
duration::duration
long::long
hold::hold
statistical::statistical
decided::decided
terms::terms
capacity::capacity
service::service
exceptions::exceptions
occur::occur
happen::happen
number::number
wanted::wanted
speak::speak
larger::larger
case::case
blocked::blocked
averages::averages
exceptional::exceptional
times::times
short::short
durations::durations
handle::handle
situation::situation
calculate::calculate
probability::probability
high::high
nowadays::nowadays
achieve::achieve
provisioning::provisioning
permits::permits
pairs::pairs
allowed::allowed
acceptable::acceptable
circumstances::circumstances
make::make
fully::fully
solution::solution
limited::limited
amount::amount
degree::degree
users::users
kinds::kinds
present::present
taxonomy::taxonomy
neatly::neatly
fit::fit
boxes::boxes
portions::portions
hybrid::hybrid
mixture::mixture
classified::classified
space::space
division::division
multiplexing::multiplexing
frequency::frequency
single::single
stage::stage
multistage::multistage
matrix::matrix
knockout::knockout
shuffle::shuffle
exchange::exchange
multipath::multipath
delta::delta
benes::benes
sorting::sorting
shared::shared
central::central
bus::bus
ring::ring
detail::detail
common::common
developed::developed
analog::analog
environment::environment
separate::separate
physical::physical
unlike::unlike
slots::slots
simplest::simplest
cross::cross
bar::bar
points::points
grows::grows
square::square
loss::loss
prevents::prevents
bad::bad
inefficient::inefficient
quick::quick
i.e::i.e
fourth::fourth
crosses::crosses
back::back
crossing::crossing
four::four
drawback::drawback
n::-NONE-
poor::poor
utilization::utilization
totally::totally
feed::feed
n2electronic::n2electronic
full::full
duplex::duplex
communication::communication
directions::directions
half::half
possibly::possibly
diagonal::diagonal
top::top
bottom::bottom
principal::principal
general::general
i::NNP
pins::pins
put::put
chip::chip
sophisticated::sophisticated
design::design
ways::ways
queuing::queuing
introduced::introduced
at&t::at&t
issues::issues
pump::pump
bits::bits
drop::drop
queue::queue
ports::ports
inlets::inlets
outlets::outlets
operate::operate
speed::speed
consists::consists
broadcast::broadcast
inlet::inlet
interface::interface
units::units
outlet::outlet
takes::takes
delivers::delivers
figure::figure
receive::receive
unit::unit
supposed::supposed
meant::meant
simply::simply
ignore::ignore
fairly::fairly
scheme::scheme
reduced::reduced
fast::fast
works::works
inside::inside
technically::technically
feasible::feasible
showed::showed
earlier::earlier
commonly::commonly
architecture::architecture
concerned::concerned
highest::highest
reduce::reduce
cost::cost
stages::stages
advantage::advantage
increases::increases
reliability::reliability
pair::pair
desirable::desirable
communicate::communicate
complex::complex
large::large
grouped::grouped
small::small
groups::groups
problems::problems
identical::identical
blocks::blocks
forming::forming
consisting::consisting
modules::modules
guess::guess
multiple::multiple
cheaper::cheaper
manufacture::manufacture
handles::handles
fashion::fashion
interconnection::interconnection
drastically::drastically
system::system
17-28::17-28
suppose::suppose
numbered::numbered
code::code
binary::binary
lower::lower
upper::upper
starting::starting
maintaining::maintaining
rule::rule
bit::bit
connects::connects
constructed::constructed
regular::regular
patterns::patterns
suitable::suitable
large-scale::large-scale
integration::integration
shown::shown
requiring::requiring
log_k::log_k
log-k::log-k
picture::picture
diagram::diagram
bigger::bigger
four-stage::four-stage
decides::decides
banyan::banyan
doing::doing
contention::contention
simultaneously::simultaneously
switched::switched
contend::contend
similarly::similarly
straight::straight
42-31::42-31
1,0::1,0
converging::converging
proceed::proceed
wait::wait
putting::putting
buffer::buffer
dropped::dropped
save::save
buffers::buffers
increase::increase
internal::internal
relative::relative
external::external
backward::backward
feedback::feedback
techniques::techniques
providing::providing
discussed::discussed
faster::faster
pumping::pumping
streams::streams
notice::notice
give::give
re-circulates::re-circulates
parallel::parallel
links::links
internally::internally
collide::collide
batcher::batcher
shuffling::shuffling
contending::contending
34-57::34-57
smaller::smaller
chunks::chunks
show::show
three-stage::three-stage
replaced::replaced
58-35::58-35
reduces::reduces
24,000::24,000
500,000::500,000
breaking::breaking
taking::taking
value::value
simultaneous::simultaneous
mentioned::mentioned
phone::phone
lying::lying
idle::idle
makes::makes
finds::finds
sufficient::sufficient
low::low
fitting::fitting
total::total
module::module
directed::directed
last::last
interconnect::interconnect
permanent::permanent
held::held
usual::usual
cell-by-cell::cell-by-cell
conversation::conversation
divided::divided
cell::cell
individually::individually
cell-based::cell-based
tag::tag
versus::versus
network-based::network-based
tables::tables
tags::tags
table::table
slower::slower
change::change
encoding::encoding
specifically::specifically
address::address
self-routing::self-routing
augmented::augmented
include::include
extra::extra
header::header
information::information
enter::enter
add::add
siemens::siemens
atm::atm
53-byte::53-byte
octet::octet
byte::byte
64-byte::64-byte
enters::enters
bytes::bytes
speeds::speeds
process::process
connection-based::connection-based
determined::determined
entire::entire
remains::remains
follow::follow
designated::designated
originating::originating
guarantees::guarantees
proper::proper
sequencing::sequencing
refused::refused
intermediate::intermediate
resource::resource
combination::combination
random::random
selection::selection
load::load
specially::specially
defect::defect
loaded::loaded
careful::careful
arrive::arrive
correct::correct
centrally::centrally
step-by-step::step-by-step
connectionless::connectionless
lookup::lookup
costly::costly
possibility::possibility
connections-oriented::connections-oriented
complete::complete
sharing::sharing
bursts::bursts
equal::equal
loads::loads
share::share
partitioning::partitioning
unbalanced::unbalanced
partial::partial
centralized::centralized
distributed::distributed
strategies::strategies
principle::principle
channels::channels
specific::specific
slot::slot
channel::channel
round::round
robin::robin
frame::frame
fixed::fixed
read::read
ram::ram
constitutes::constitutes
mapping::mapping
reads::reads
step::step
puts::puts
reading::reading
effect::effect
moment::moment
bidirectional::bidirectional
components::components
tdm::tdm
details::details
dedicated::dedicated
distinct::distinct
program::program
written::written
completely::completely
printed::printed
writing::writing
card::card
dma::dma
serial::serial
studied::studied
operating::operating
access::access
intervention::intervention
cpu::cpu
port::port
hardware::hardware
operation::operation
memories::memories
simplified::simplified
serially::serially
converter::converter
converting::converting
fed::fed
database::database
entries::entries
consecutive::consecutive
generated::generated
feeding::feeding
list::list
pointer::pointer
values::values
basis::basis
decimal::decimal
representation::representation
content::content
assuming::assuming
processed::processed
micro::micro
seconds::seconds
requires::requires
kbps::kbps
gap::gap
64,000::64,000
hierarchy::hierarchy
sacred::sacred
sticks::sticks
smoothly::smoothly
higher::higher
pack::pack
size::size
cycle::cycle
2nt::2nt
operations::operations
write::write
nanoseconds::nanoseconds
constraint::constraint
allocation::allocation
providers::providers
manner::manner
formula::formula
average::average
arrival::arrival
rate::rate
exponential::exponential
holding::holding
poisson::poisson
erlangs::erlangs
allocate::allocate
level::level
typically::typically
typical::typical
difference::difference
calculating::calculating
giving::giving
verify::verify
erlang-b::erlang-b
stirlings::stirlings
approximation::approximation
handling::handling
factorial::factorial
designed::designed
packets::packets
quit::quit
motivation::motivation
performance::performance
lan::lan
considerably::considerably
enhanced::enhanced
moving::moving
lans::lans
earliest::earliest
glance::glance
hub::hub
nodes::nodes
boost::boost
place::place
source::source
scale::scale
43-57::43-57
replace::replace
virtual::virtual
setup::setup
transmit::transmit
concept::concept
fact::fact
develop::develop
work::work
rest::rest
53-58::53-58
ethernet::ethernet
type::type
matter::matter
hare::hare
regularly::regularly
produce::produce
amountize::amountize
development::development
cheap::cheap
days::days
lack::lack
ten::ten
fifteen::fifteen
years::years
thousand::thousand
rupees::rupees
