collection of interrelated::collection of interrelated
set of programs::set of programs
programs to access::programs to access
access those data::access those data
data the collection::data the collection
collection of data::collection of data
enterprise the primary::enterprise the primary
store and retrieve::store and retrieve
retrieve database information::retrieve database information
convenient and efficient::convenient and efficient
efficient database systems::efficient database systems
systems are designed::systems are designed
designed to manage::designed to manage
manage large bodies::manage large bodies
bodies of information::bodies of information
management of data::management of data
involves both defining::involves both defining
structures for storage::structures for storage
storage of information::storage of information
information and providing::information and providing
manipulation of information::manipulation of information
information in addition::information in addition
system must ensure::system must ensure
ensure the safety::ensure the safety
crashes or attempts::crashes or attempts
attempts at unauthorized::attempts at unauthorized
access if data::access if data
system must avoid::system must avoid
avoid possible anomalous::avoid possible anomalous
results because information::results because information
scientists have developed::scientists have developed
developed a large::developed a large
body of concepts::body of concepts
concepts and techniques::concepts and techniques
techniques for managing::techniques for managing
data these concepts::data these concepts
form the focus::form the focus
book this chapter::book this chapter
chapter briefly introduces::chapter briefly introduces
introduces the principles::introduces the principles
principles of database::principles of database
database-system applications databases::database-system applications databases
enterprise information sales::enterprise information sales
purchase information accounting::purchase information accounting
accounting information human::accounting information human
information human resources::information human resources
information about employees::information about employees
generation of paychecks::generation of paychecks
production of items::production of items
items in factories::items in factories
inventories of items::inventories of items
inwarehouses and stores::inwarehouses and stores
orders for items::orders for items
introduction online retailers::introduction online retailers
sales data noted::sales data noted
online order tracking::online order tracking
generation of recommendation::generation of recommendation
maintenance of online::maintenance of online
online product evaluations::online product evaluations
evaluations ? banking::evaluations ? banking
banking and finance::banking and finance
banking transactions credit::banking transactions credit
transactions credit card::transactions credit card
credit card transactions::credit card transactions
purchases on credit::purchases on credit
cards and generation::cards and generation
generation of monthly::generation of monthly
monthly statements finance::monthly statements finance
information about holdings::information about holdings
purchases of financial::purchases of financial
stocks and bonds::stocks and bonds
storing real-time market::storing real-time market
real-time market data::real-time market data
data to enable::data to enable
enable online trading::enable online trading
trading by customers::trading by customers
customers and automated::customers and automated
firm ? universities::firm ? universities
addition to standard::addition to standard
standard enterprise information::standard enterprise information
resources and accounting::resources and accounting
reservations and schedule::reservations and schedule
schedule information airlines::schedule information airlines
geographically distributed manner::geographically distributed manner
manner ? telecommunication::manner ? telecommunication
records of calls::records of calls
generating monthly bills::generating monthly bills
balances on prepaid::balances on prepaid
prepaid calling cards::prepaid calling cards
form an essential::form an essential
types of information::types of information
last four decades::last four decades
grewin all enterprises::grewin all enterprises
directly with database::directly with database
interacted with databases::interacted with databases
credit card statements::credit card statements
tellers and airline::tellers and airline
airline reservation agents::airline reservation agents
agents then automated::agents then automated
automated teller machines::automated teller machines
directly with databases::directly with databases
databases phone interfaces::databases phone interfaces
interfaces to computers::interfaces to computers
interactive voice-response systems::interactive voice-response systems
users to deal::users to deal
caller could dial::caller could dial
dial a number::dial a number
press phone keys::press phone keys
keys to enter::keys to enter
select alternative options::select alternative options
flight arrival times::flight NN times
register for courses::register for courses
university the internet::university the internet
1990s sharply increased::1990s sharply increased
sharply increased direct::sharply increased direct
increased direct user::increased direct user
direct user access::direct user access
access to databases::access to databases
databases organizations converted::databases organizations converted
interfaces to databases::interfaces to databases
databases into web::databases into web
made a variety::made a variety
variety of services::variety of services
services and information::services and information
information available online::information available online
online for instance::online for instance
access an online::access an online
bookstore and browse::bookstore and browse
browse a book::browse a book
book or music::book or music
accessing data stored::accessing data stored
enter an order::enter an order
order is stored::order is stored
database.when you access::database.when you access
access a bankweb::access a bankweb
site and retrieve::site and retrieve
retrieve your bank::retrieve your bank
balance and transaction::balance and transaction
information is retrieved::information is retrieved
system.when you access::system.when you access
access aweb site::access aweb site
purpose of database::purpose of database
database to select::database to select
select which advertisements::select which advertisements
user interfaces hide::user interfaces hide
interfaces hide details::interfaces hide details
details of access::details of access
accessing databases forms::accessing databases forms
forms an essential::forms an essential
today the importance::today the importance
importance of database::importance of database
database system vendors::database system vendors
vendors like oracle::vendors like oracle
largest software companies::largest software companies
database systems form::database systems form
form an important::form an important
line of microsoft::line of microsoft
microsoft and ibm::microsoft and ibm
database systems database::database systems database
systems database systems::systems database systems
database systems arose::database systems arose
arose in response::arose in response
methods of computerized::methods of computerized
management of commercial::management of commercial
operating system files::operating system files
users to manipulate::users to manipulate
manipulate the information::manipulate the information
number of application::number of application
programs that manipulate::programs that manipulate
manipulate the files::manipulate the files
add new students::add new students
courses ? register::courses ? register
students for courses::students for courses
courses and generate::courses and generate
generate class rosters::generate class rosters
rosters ? assign::rosters ? assign
grades to students::grades to students
compute grade point::compute grade point
grade point averages::grade point averages
generate transcripts system::generate transcripts system
transcripts system programmers::transcripts system programmers
system programmers wrote::system programmers wrote
wrote these application::wrote these application
programs to meet::programs to meet
university new application::university new application
programs are added::programs are added
decides to create::decides to create
.as a result::.as a result
creates a newdepartment::creates a newdepartment
newdepartment and creates::newdepartment and creates
creates new permanent::creates new permanent
information to existing::information to existing
write new application::write new application
programs to deal::programs to deal
deal with rules::deal with rules
major new application::major new application
written to handle::written to handle
handle new rules::handle new rules
acquires more files::acquires more files
programs this typical::programs this typical
typical file-processing system::typical file-processing system
system is supported::system is supported
conventional operating system::conventional operating system
system the system::system the system
system stores permanent::system stores permanent
stores permanent records::stores permanent records
programs to extract::programs to extract
files before database::files before database
database management systems::database management systems
organizations usually stored::organizations usually stored
systems keeping organizational::systems keeping organizational
keeping organizational information::keeping organizational information
number of major::number of major
introduction ? data::introduction ? data
redundancy and inconsistency::redundancy and inconsistency
create the files::create the files
files and application::files and application
programs may bewritten::programs may bewritten
music and mathematics::music and mathematics
address and telephone::address and telephone
file that consists::file that consists
consists of student::consists of student
records of students::records of students
department this redundancy::department this redundancy
leads to higher::leads to higher
storage and access::storage and access
cost in addition::cost in addition
lead to data::lead to data
datamayno longer agree::datamayno longer agree
changed student address::changed student address
music department records::music department records
system ? difficulty::system ? difficulty
difficulty in accessing::difficulty in accessing
accessing data suppose::accessing data suppose
out the names::out the names
students who live::students who live
area the clerk::area the clerk
asks the data-processing::asks the data-processing
department to generate::department to generate
anticipate this request::anticipate this request
program on hand::program on hand
hand to meet::hand to meet
program to generate::program to generate
generate the list::generate the list
students the university::students the university
obtain the list::obtain the list
students and extract::students and extract
extract the needed::extract the needed
programmer to write::programmer to write
program both alternatives::program both alternatives
program is written::program is written
trim that list::trim that list
list to include::list to include
hours as expected::hours as expected
preceding two options::preceding two options
satisfactory the point::satisfactory the point
conventional file-processing environments::conventional file-processing environments
convenient and efficientmanner::convenient and efficientmanner
efficientmanner more responsive::efficientmanner more responsive
responsive data-retrieval systems::responsive data-retrieval systems
systems are required::systems are required
required for general::required for general
isolation because data::isolation because data
data are scattered::data are scattered
writing new application::writing new application
programs to retrieve::programs to retrieve
data is difficult::data is difficult
difficult ? integrity::difficult ? integrity
problems the data::problems the data
data values stored::data values stored
database must satisfy::database must satisfy
satisfy certain types::satisfy certain types
types of consistency::types of consistency
consistency constraints suppose::consistency constraints suppose
suppose the university::suppose the university
maintains an account::maintains an account
records the balance::records the balance
enforce these constraints::enforce these constraints
system by adding::system by adding
adding appropriate code::adding appropriate code
constraints are added::constraints are added
difficult to change::difficult to change
change the programs::change the programs
programs to enforce::programs to enforce
problem is compoundedwhen::problem is compoundedwhen
compoundedwhen constraints involve::compoundedwhen constraints involve
involve several data::involve several data
files ? atomicity::files ? atomicity
problems a computer::problems a computer
subject to failure::subject to failure
state that existed::state that existed
program to transfer::program to transfer
balance of department::balance of department
system failure occurs::system failure occurs
department a butwas::department a butwas
butwas not credited::butwas not credited
inconsistent database state::inconsistent database state
essential to database::essential to database
credit and debit::credit and debit
difficult to ensure::difficult to ensure
conventional file-processing system::conventional file-processing system
system ? concurrent-access::system ? concurrent-access
system and faster::system and faster
systems allow multiple::systems allow multiple
users to update::users to update
update the data::update the data
largest internet retailers::largest internet retailers
millions of accesses::millions of accesses
accesses per day::accesses per day
data by shoppers::data by shoppers
interaction of concurrent::interaction of concurrent
result in inconsistent::result in inconsistent
data consider department::data consider department
two department clerks::two department clerks
department clerks debit::department clerks debit
debit the account::debit the account
executions may leave::executions may leave
leave the budget::leave the budget
executing on behalf::executing on behalf
reduce that value::reduce that value
write the result::write the result
two programs run::two programs run
read the value::read the value
writes the value::writes the value
system must maintain::system must maintain
maintain some form::maintain some form
form of supervision::form of supervision
supervision but supervision::supervision but supervision
supervision is difficult::supervision is difficult
difficult to provide::difficult to provide
provide because data::provide because data
suppose a registration::suppose a registration
registration program maintains::registration program maintains
maintains a count::maintains a count
count of students::count of students
order to enforce::order to enforce
number of students::number of students
registered.when a student::registered.when a student
reads the current::reads the current
stores the count::stores the count
suppose two students::suppose two students
two students register::two students register
two program executions::two program executions
students successfully registered::students successfully registered
case both students::case both students
students ? security::students ? security
access to information::access to information
information about academic::information about academic
enforcing such security::enforcing such security
constraints is difficult::constraints is difficult
introduction these difficulties::introduction these difficulties
prompted the development::prompted the development
development of database::development of database
concepts and algorithms::concepts and algorithms
algorithms that enable::algorithms that enable
enable database systems::enable database systems
systems to solve::systems to solve
solve the problems::solve the problems
problems with file-processing::problems with file-processing
typical data-processing application::typical data-processing application
view of data::view of data
data a database::data a database
users to access::users to access
access and modify::access and modify
modify these data::modify these data
data a major::data a major
hides certain details::hides certain details
data are stored::data are stored
stored and maintained::stored and maintained
maintained 1.3.1 data::maintained 1.3.1 data
1.3.1 data abstraction::1.3.1 data abstraction
retrieve data efficiently::retrieve data efficiently
efficiency has led::efficiency has led
complex data structures::complex data structures
structures to represent::structures to represent
hide the complexity::hide the complexity
complexity from users::complexity from users
levels of abstraction::levels of abstraction
users ? interactions::users ? interactions
level the lowest::level the lowest
level of abstraction::level of abstraction
stored the physical::stored the physical
physical level describes::physical level describes
level describes complex::level describes complex
describes complex low-level::describes complex low-level
complex low-level data::complex low-level data
low-level data structures::low-level data structures
structures in detail::structures in detail
detail ? logical::detail ? logical
level the next-higher::level the next-higher
describes what data::describes what data
data the logical::data the logical
level thus describes::level thus describes
describes the entire::describes the entire
database in terms::database in terms
structures although implementation::structures although implementation
level may involve::level may involve
involve complex physical-level::involve complex physical-level
complex physical-level structures::complex physical-level structures
physical data independence::physical data independence
data independence database::data independence database
independence database administrators::independence database administrators
decide what information::decide what information
abstraction ? view::abstraction ? view
level the highest::level the highest
describes only part::describes only part
level uses simpler::level uses simpler
variety of information::variety of information
database many users::database many users
database the view::database the view
exists to simplify::exists to simplify
simplify their interaction::simplify their interaction
system may provide::system may provide
provide many views::provide many views
shows the relationship::shows the relationship
abstraction an analogy::abstraction an analogy
concept of data::concept of data
types in programming::types in programming
languages may clarify::languages may clarify
clarify the distinction::clarify the distinction
distinction among levels::distinction among levels
abstraction many high-level::abstraction many high-level
high-level programming thesumit67.blogspot.com::high-level programming thesumit67.blogspot.com
logical level physical::logical level physical
level physical level::level physical level
level ? view::level ? view
view n view::view n view
view level figure::view level figure
levels of data::levels of data
data abstraction languages::data abstraction languages
abstraction languages support::abstraction languages support
support the notion::support the notion
describe a record::describe a record
instructor = record::instructor = record
type called instructor::type called instructor
fields each field::fields each field
including ? department::including ? department
credits ? student::credits ? student
block of consecutive::block of consecutive
consecutive storage locations::consecutive storage locations
locations the compiler::locations the compiler
hides this level::hides this level
level of detail::level of detail
detail from programmers::detail from programmers
database system hides::database system hides
lowest-level storage details::lowest-level storage details
details from database::details from database
database programmers database::database programmers database
programmers database administrators::programmers database administrators
data 1the actual::data 1the actual
1the actual type::1the actual type
actual type declaration::actual type declaration
type declaration depends::type declaration depends
struct declarations java::struct declarations java
record is described::record is described
previous code segment::previous code segment
types is defined::types is defined
programming language work::programming language work
administrators usually work::administrators usually work
set of application::set of application
database are defined::database are defined
database user sees::database user sees
views in addition::views in addition
addition to hiding::addition to hiding
views also provide::views also provide
provide a security::provide a security
mechanism to prevent::mechanism to prevent
users from accessing::users from accessing
accessing certain parts::accessing certain parts
university registrar office::university registrar office
information about students::information about students
information about salaries::information about salaries
salaries of instructors::salaries of instructors
instructors 1.3.2 instances::instructors 1.3.2 instances
instances and schemas::instances and schemas
schemas databases change::schemas databases change
information is inserted::information is inserted
inserted and deleted::inserted and deleted
deleted the collection::deleted the collection
collection of information::collection of information
database schema schemas::database schema schemas
schemas are changed::schemas are changed
concept of database::concept of database
schemas and instances::schemas and instances
understood by analogy::understood by analogy
programming language.adatabase schema::programming language.adatabase schema
language.adatabase schema corresponds::language.adatabase schema corresponds
program each variable::program each variable
instant the values::instant the values
database schema database::database schema database
schema database systems::schema database systems
abstraction the physical::abstraction the physical
physical schema describes::physical schema describes
describes the database::describes the database
logical schema describes::logical schema describes
level a database::level a database
describe different views::describe different views
effect on application::effect on application
programmers construct applications::programmers construct applications
schema the physical::schema the physical
schema is hidden::schema is hidden
beneath the logical::beneath the logical
easily without affecting::easily without affecting
affecting application programs::affecting application programs
application programs application::application programs application
programs application programs::programs application programs
exhibit physical data::exhibit physical data
languages for describing::languages for describing
schemas after introducing::schemas after introducing
introducing the notion::introducing the notion
notion of data::notion of data
section 1.3.3 data::section 1.3.3 data
1.3.3 data models::1.3.3 data models
data models underlying::data models underlying
underlying the structure::underlying the structure
collection of conceptual::collection of conceptual
tools for describing::tools for describing
constraints a data::constraints a data
describe the design::describe the design
view levels thesumit67.blogspot.com::view levels thesumit67.blogspot.com
text the data::text the data
four different categories::four different categories
model the relational::model the relational
collection of tables::collection of tables
tables to represent::tables to represent
represent both data::represent both data
data each table::data each table
table has multiple::table has multiple
unique name tables::unique name tables
relations the relational::relations the relational
record-based model record-based::record-based model record-based
model record-based models::model record-based models
database is structured::database is structured
structured in fixed-format::structured in fixed-format
types each table::types each table
table contains records::table contains records
type each record::type each record
record type defines::record type defines
defines a fixed::defines a fixed
number of fields::number of fields
attributes the columns::attributes the columns
type the relational::type the relational
relational data model::relational data model
widely used data::widely used data
majority of current::majority of current
current database systems::current database systems
systems are based::systems are based
relational model chapters::relational model chapters
cover the relational::cover the relational
model in detail::model in detail
detail ? entity-relationship::detail ? entity-relationship
model the entity-relationship::model the entity-relationship
collection of basic::collection of basic
objects an entity::objects an entity
objects the entity-relationship::objects the entity-relationship
detail ? object-based::detail ? object-based
object-based data model.object-oriented::object-based data model.object-oriented
data model.object-oriented programming::data model.object-oriented programming
dominant software-development methodology::dominant software-development methodology
methodology this led::methodology this led
object-oriented data model::object-oriented data model
extending the e-r::extending the e-r
model with notions::model with notions
notions of encapsulation::notions of encapsulation
identity the object-relational::identity the object-relational
object-relational data model::object-relational data model
data model combines::data model combines
model combines features::model combines features
model and relational::model and relational
data model chapter::data model chapter
examines the object-relational::examines the object-relational
model ? semistructured::model ? semistructured
semistructured data model::semistructured data model
model the semistructured::model the semistructured
data model permits::data model permits
permits the specification::permits the specification
specification of data::specification of data
data where individual::data where individual
individual data items::individual data items
sets of attributes::sets of attributes
data models mentioned::data models mentioned
models mentioned earlier::models mentioned earlier
set of attributes::set of attributes
attributes the extensible::attributes the extensible
extensible markup language::extensible markup language
represent semistructured data::represent semistructured data
semistructured data chapter::semistructured data chapter
network data model::network data model
hierarchical data model::hierarchical data model
data model preceded::data model preceded
preceded the relational::preceded the relational
model these modelswere::model these modelswere
complicated the task::complicated the task
task of modeling::task of modeling
online in appendices::online in appendices
languages a database::languages a database
language to express::language to express
express database queries::express database queries
queries and upthesumit67::queries and upthesumit67
dates in practice::dates in practice
data-definition and data-manipulation::data-definition and data-manipulation
two separate languages::two separate languages
simply form parts::simply form parts
single database language::single database language
widely used sql::widely used sql
language 1.4.1 data-manipulation::language 1.4.1 data-manipulation
1.4.1 data-manipulation language::1.4.1 data-manipulation language
language a data-manipulation::language a data-manipulation
language that enables::language that enables
access or manipulate::access or manipulate
data as organized::data as organized
model the types::model the types
types of access::types of access
retrieval of information::retrieval of information
database ? insertion::database ? insertion
database ? deletion::database ? deletion
deletion of information::deletion of information
database ? modification::database ? modification
modification of information::modification of information
basically two types::basically two types
procedural dmls require::procedural dmls require
require a user::require a user
data are needed::data are needed
data ? declarative::data ? declarative
data declarative dmls::data declarative dmls
easier to learn::easier to learn
out an efficient::out an efficient
means of accessing::means of accessing
data a query::data a query
requesting the retrieval::requesting the retrieval
information the portion::information the portion
dml that involves::dml that involves
involves information retrieval::involves information retrieval
terms query language::terms query language
language and data-manipulation::language and data-manipulation
data-manipulation language synonymously::data-manipulation language synonymously
number of database::number of database
database query languages::database query languages
commercially or experimentally.we::commercially or experimentally.we
widely used query::widely used query
languages in chapter::languages in chapter
discussed in section::discussed in section
defining or structuring::defining or structuring
access to data::access to data
data at higher::data at higher
humans to interact::humans to interact
system the query::system the query
query processor component::query processor component
study in chapters::study in chapters
translates dml queries::translates dml queries
queries into sequences::queries into sequences
sequences of actions::sequences of actions
system 1.4.2 data-definition::system 1.4.2 data-definition
1.4.2 data-definition language::1.4.2 data-definition language
set of definitions::set of definitions
structure and access::structure and access
set of statements::set of statements
type of ddl::type of ddl
storage and definition::storage and definition
language these statements::language these statements
define the implementation::define the implementation
users the data::users the data
satisfy certain consistency::satisfy certain consistency
negative the ddl::negative the ddl
ddl provides facilities::ddl provides facilities
constraints the database::constraints the database
database system checks::database system checks
checks these constraints::checks these constraints
database is updated::database is updated
updated in general::updated in general
arbitrary predicate pertaining::arbitrary predicate pertaining
costly to test::costly to test
database systems implement::database systems implement
systems implement integrity::systems implement integrity
implement integrity constraints::implement integrity constraints
testedwith minimal overhead::testedwith minimal overhead
constraints a domain::constraints a domain
declaring an attribute::declaring an attribute
form of integrity::form of integrity
item is entered::item is entered
database ? referential::database ? referential
value that appears::value that appears
attributes also appears::attributes also appears
dept name value::dept name value
dept name attribute::dept name attribute
department relation database::department relation database
relation database modifications::relation database modifications
violations of referential::violations of referential
integrity.when a referential-integrity::integrity.when a referential-integrity
constraint is violated::constraint is violated
reject the action::reject the action
action that caused::action that caused
caused the violation::caused the violation
violation ? assertions::violation ? assertions
assertions an assertion::assertions an assertion
satisfy domain constraints::satisfy domain constraints
constraints and referential-integrity::constraints and referential-integrity
constraints are special::constraints are special
forms of assertions::forms of assertions
offered every semester::offered every semester
assertion is created::assertion is created
assertion is valid::assertion is valid
database is allowed::database is allowed
violated ? authorization::violated ? authorization
type of access::type of access
database these differentiations::database these differentiations
differentiations are expressed::differentiations are expressed
expressed in terms::expressed in terms
terms of authorization::terms of authorization
data ; insert::data ; insert
modification of existing::modification of existing
data ; update::data ; update
deletion of data::deletion of data
assign the user::assign the user
types of authorization::types of authorization
introduction the ddl::introduction the ddl
input some instructions::input some instructions
generates some output::generates some output
output the output::output the output
dictionary,which contains metadata::dictionary,which contains metadata
data about data::data about data
data the data::data the data
dictionary is considered::dictionary is considered
type of table::type of table
accessed and updated::accessed and updated
database system consults::database system consults
consults the data::consults the data
dictionary before reading::dictionary before reading
reading or modifying::reading or modifying
modifying actual data::modifying actual data
databases a relational::databases a relational
database is based::database is based
includes a dml::includes a dml
dml and ddl::dml and ddl
ddl in chapter::ddl in chapter
present a gentle::present a gentle
model most commercial::model most commercial
commercial relational database::commercial relational database
relational database systems::relational database systems
database systems employ::database systems employ
employ the sql::employ the sql
cover in great::cover in great
detail in chapters::detail in chapters
discuss other influential::discuss other influential
languages 1.5.1 tables::languages 1.5.1 tables
tables each table::tables each table
unique name figure::unique name figure
presents a sample::presents a sample
sample relational database::sample relational database
relational database comprising::relational database comprising
comprising two tables::comprising two tables
details of university::details of university
departments the first::departments the first
instructor named einstein::instructor named einstein
department is located::department is located
departments and instructors::departments and instructors
text to illustrate::text to illustrate
concepts a larger::concepts a larger
online the relational::online the relational
stored in files::stored in files
files for instance::files for instance
records the relational::records the relational
relational model hides::relational model hides
hides such low-level::hides such low-level
low-level implementation details::low-level implementation details
developers and users::developers and users
unnecessarily duplicated information::unnecessarily duplicated information
suppose we store::suppose we store
store the department::store the department
dept name salary::dept name salary
katz comp sci::katz comp sci
kim elec eng::kim elec eng
srinivasan comp sci::srinivasan comp sci
brandt comp sci::brandt comp sci
instructor table dept::instructor table dept
dept name building::dept name building
building budget comp::building budget comp
budget comp sci::budget comp sci
comp sci taylor::comp sci taylor
elec eng taylor::elec eng taylor
department table figure::department table figure
department in chapter::department in chapter
distinguish good schema::distinguish good schema
good schema designs::good schema designs
designs from bad::designs from bad
bad schema designs::bad schema designs
designs 1.5.2 data-manipulation::designs 1.5.2 data-manipulation
1.5.2 data-manipulation language::1.5.2 data-manipulation language
language the sql::language the sql
sql query language::sql query language
language is nonprocedural::language is nonprocedural
nonprocedural a query::nonprocedural a query
takes as input::takes as input
input several tables::input several tables
returns a single::returns a single
query that finds::query that finds
finds the names::finds the names
instructor.name from instructor::instructor.name from instructor
instructor where instructor.dept::instructor where instructor.dept
rows fromthe table::rows fromthe table
fromthe table instructor::fromthe table instructor
historymust be retrieved::historymust be retrieved
result of executing::result of executing
executing this query::executing this query
single column thesumit67.blogspot.com::single column thesumit67.blogspot.com
set of rows::set of rows
instructor whose dept::instructor whose dept
query is run::query is run
table in figure::table in figure
result will consist::result will consist
queries may involve::queries may involve
table for instance::table for instance
finds the instructor::finds the instructor
department with budget::department with budget
budget of greater::budget of greater
95,000 select instructor.id::95,000 select instructor.id
department where instructor.dept::department where instructor.dept
query were run::query were run
tables in figure::tables in figure
system would find::system would find
departments with budget::departments with budget
95,000 ? computer::95,000 ? computer
science and finance::science and finance
1.5.3 data-definition language::1.5.3 data-definition language
data-definition language sql::data-definition language sql
sql ddl statement::sql ddl statement
ddl statement defines::ddl statement defines
defines the department::defines the department
create table department::create table department
dept name char::dept name char
ddl statement creates::ddl statement creates
creates the department::creates the department
specific data type::specific data type
it.we discuss data::it.we discuss data
discuss data types::discuss data types
detail in chapter::detail in chapter
ddl statement updates::ddl statement updates
updates the data::updates the data
metadata 1.5.4 database::metadata 1.5.4 database
1.5.4 database access::1.5.4 database access
access from application::access from application
application programs sql::application programs sql
universal turing machine::universal turing machine
general-purpose programming language::general-purpose programming language
input from users::input from users
output to displays::output to displays
network such computations::network such computations
computations and actions::computations and actions
embedded sql queries::embedded sql queries
queries that access::queries that access
access the data::access the data
database application programs::database application programs
programs are programs::programs are programs
system are programs::system are programs
students to register::students to register
calculate student gpa::calculate student gpa
generate payroll checks::generate payroll checks
access the database::access the database
providing an application::providing an application
application program interface::application program interface
set of procedures::set of procedures
database and retrieve::database and retrieve
retrieve the results::retrieve the results
results the open::results the open
open database connectivity::open database connectivity
commonly used application::commonly used application
program interface standard::program interface standard
standard the java::standard the java
java database connectivity::java database connectivity
extending the host::extending the host
host language syntax::host language syntax
syntax to embed::syntax to embed
embed dml calls::embed dml calls
host language program::host language program
special character prefaces::special character prefaces
character prefaces dml::character prefaces dml
prefaces dml calls::prefaces dml calls
converts the dml::converts the dml
statements to normal::statements to normal
normal procedure calls::normal procedure calls
database design database::database design database
design database systems::design database systems
information these large::information these large
exist in isolation::exist in isolation
enterprise whose end::enterprise whose end
device or service::device or service
supporting role database::supporting role database
role database design::role database design
design mainly involves::design mainly involves
involves the design::involves the design
schema the design::schema the design
complete database application::complete database application
database application environment::database application environment
environment that meets::environment that meets
enterprise being modeled::enterprise being modeled
modeled requires attention::modeled requires attention
set of issues::set of issues
writing of database::writing of database
design of database::design of database
database schemas chapter::database schemas chapter
process of application::process of application
design 1.6.1 design::design 1.6.1 design
1.6.1 design process::1.6.1 design process
process a high-level::process a high-level
high-level data model::high-level data model
designerwith a conceptual::designerwith a conceptual
structured to fulfill::structured to fulfill
fulfill these requirements::fulfill these requirements
requirements the initial::requirements the initial
phase of database::phase of database
fully the data::fully the data
prospective database users::prospective database users
users the database::users the database
extensively with domain::extensively with domain
experts and users::experts and users
users to carry::users to carry
out this task::out this task
task the outcome::task the outcome
specification of user::specification of user
chooses a data::chooses a data
applying the concepts::applying the concepts
translates these requirements::translates these requirements
database the schema::database the schema
enterprise the designer::enterprise the designer
reviews the schema::reviews the schema
schema to confirm::schema to confirm
examine the design::examine the design
design to remove::design to remove
remove any redundant::remove any redundant
features the focus::features the focus
describing the data::describing the data
physical storage details::physical storage details
details in terms::details in terms
conceptual-design process involves::conceptual-design process involves
process involves decisions::process involves decisions
group these attributes::group these attributes
attributes to form::attributes to form
basically a business::basically a business
principally two ways::principally two ways
ways to tackle::ways to tackle
tackle the problem::tackle the problem
problem the first::problem the first
employ a set::employ a set
set of algorithms::set of algorithms
input the set::input the set
attributes and generates::attributes and generates
generates a set::generates a set
set of tables::set of tables
fully developed conceptual::fully developed conceptual
developed conceptual schema::developed conceptual schema
specification of functional::specification of functional
describe the kinds::describe the kinds
kinds of operations::kinds of operations
data example operations::data example operations
operations include modifying::operations include modifying
modifying or updating::modifying or updating
retrieving specific data::retrieving specific data
stage of conceptual::stage of conceptual
designer can review::designer can review
review the schema::review the schema
schema to ensure::schema to ensure
ensure it meets::ensure it meets
meets functional requirements::meets functional requirements
requirements the process::requirements the process
process of moving::process of moving
abstract data model::abstract data model
two final design::two final design
final design phases::final design phases
maps the high-level::maps the high-level
high-level conceptual schema::high-level conceptual schema
implementation data model::implementation data model
resulting system-specific database::resulting system-specific database
system-specific database schema::system-specific database schema
subsequent physical-design phase::subsequent physical-design phase
include the form::include the form
form of file::form of file
internal storage structures::internal storage structures
discussed in chapter::discussed in chapter
1.6.2 database design::1.6.2 database design
organization to illustrate::organization to illustrate
illustrate the design::illustrate the design
designed the initial::designed the initial
based on interviews::based on interviews
organization the description::organization the description
description that arises::description that arises
design phase serves::design phase serves
university is organized::university is organized
organized into departments::organized into departments
departments each department::departments each department
department is identified::department is identified
list of courses::list of courses
courses it offers::courses it offers
prerequisites ? instructors::prerequisites ? instructors
instructors are identified::instructors are identified
salary ? students::salary ? students
students are identified::students are identified
total credit hours::total credit hours
hours the student::hours the student
maintains a list::maintains a list
list of classrooms::list of classrooms
taught each section::taught each section
section is identified::section is identified
list of teaching::list of teaching
sections the instructor::sections the instructor
instructor is teaching::instructor is teaching
student course registrations::student course registrations
real university database::real university database
understand conceptual ideas::understand conceptual ideas
lost in details::lost in details
1.6.3 the entity-relationship::1.6.3 the entity-relationship
considered as entities::considered as entities
entities are described::entities are described
budget may describe::budget may describe
department entity set::department entity set
salary may describe::salary may describe
describe an instructor::describe an instructor
entity.2 the extra::entity.2 the extra
identify an instructor::identify an instructor
unique instructor identifier::unique instructor identifier
number the u.s::number the u.s
u.s government assigns::u.s government assigns
unique identifier arelationship::unique identifier arelationship
member relationship associates::member relationship associates
associates an instructor::associates an instructor
department the set::department the set
type are termed::type are termed
termed an entity::termed an entity
set and relationship::set and relationship
draw these diagrams::draw these diagrams
unified modeling language::unified modeling language
based on uml::based on uml
diagram is represented::diagram is represented
2the astute reader::2the astute reader
reader will notice::reader will notice
dropped the attribute::dropped the attribute
describing the instructor::describing the instructor
instructor entity set::instructor entity set
error in chapter::error in chapter
provide a detailed::provide a detailed
salary department dept_name::salary department dept_name
department dept_name building::department dept_name building
dept_name building budget::dept_name building budget
building budget member::building budget member
budget member figure::budget member figure
sample e-r diagram::sample e-r diagram
diagram ? entity::diagram ? entity
sets are represented::sets are represented
connecting a pair::connecting a pair
pair of related::pair of related
related entity sets::related entity sets
inside the diamond::inside the diamond
university database consisting::university database consisting
consisting of instructors::consisting of instructors
diagram the e-r::diagram the e-r
two entity sets::two entity sets
instructor and department::instructor and department
attributes as outlined::attributes as outlined
earlier the diagram::earlier the diagram
diagram also shows::diagram also shows
shows a relationship::shows a relationship
member between instructor::member between instructor
department in addition::department in addition
addition to entities::addition to entities
entities and relationships::entities and relationships
e-r model represents::e-r model represents
represents certain constraints::represents certain constraints
database must conform::database must conform
conform one important::conform one important
constraint is mapping::constraint is mapping
express the number::express the number
number of entities::number of entities
model can express::model can express
express that constraint::express that constraint
constraint the entity-relationship::constraint the entity-relationship
detail 1.6.4 normalization::detail 1.6.4 normalization
normalization another method::normalization another method
method for designing::method for designing
designing a relational::designing a relational
normalization the goal::normalization the goal
generate a set::generate a set
set of relation::set of relation
information without unnecessary::information without unnecessary
retrieve information easily::retrieve information easily
easily the approach::easily the approach
form to determine::form to determine
desirable normal forms::desirable normal forms
cover in section::cover in section
bad database design::bad database design
repetition of information::repetition of information
information ? inability::information ? inability
inability to represent::inability to represent
represent certain information::represent certain information
discuss these problems::discuss these problems
modified database design::modified database design
university example suppose::university example suppose
two separate tables::two separate tables
separate tables instructor::separate tables instructor
combines the information::combines the information
shown in figure::shown in figure
rows in faculty::rows in faculty
building and budget::building and budget
budget the repetition::budget the repetition
design is undesirable::design is undesirable
undesirable repeating information::undesirable repeating information
repeating information wastes::repeating information wastes
information wastes space::information wastes space
updating the database::updating the database
change the budget::change the budget
46,800 this change::46,800 this change
rows ; contrast::rows ; contrast
requires an update::requires an update
perform the update::perform the update
department is updated::department is updated
database will show::database will show
two different budget::two different budget
shift our attention::shift our attention
information ? suppose::information ? suppose
alternative design above,we::alternative design above,we
directly the information::directly the information
faculty table require::faculty table require
table require values::table require values
salary this means::salary this means
newly created department::newly created department
instructor is hired::instructor is hired
department one solution::department one solution
introduce null values::introduce null values
values the null::values the null
value does exist::value does exist
value actually exists::value actually exists
values are difficult::values are difficult
difficult to handle::difficult to handle
deal with null::deal with null
itemof department information::itemof department information
delete this information::delete this information
situation is undesirable::situation is undesirable
original database design::original database design
resorting to null::resorting to null
values an extensive::values an extensive
theory of normalization::theory of normalization
developed that helps::developed that helps
helps formally define::helps formally define
define what database::define what database
designs are undesirable::designs are undesirable
obtain desirable designs::obtain desirable designs
desirable designs chapter::desirable designs chapter
covers relational-database design::covers relational-database design
storage and querying::storage and querying
querying a database::querying a database
system is partitioned::system is partitioned
partitioned into modules::partitioned into modules
modules that deal::modules that deal
system the functional::system the functional
query processor components::query processor components
components the storage::components the storage
manager is important::manager is important
important because databases::important because databases
databases typically require::databases typically require
require a large::require a large
amount of storage::amount of storage
storage space corporate::storage space corporate
space corporate databases::space corporate databases
corporate databases range::corporate databases range
range in size::range in size
size from hundreds::size from hundreds
hundreds of gigabytes::hundreds of gigabytes
terabytes of data::terabytes of data
data a gigabyte::data a gigabyte
memory of computers::memory of computers
information is stored::information is stored
stored on disks::stored on disks
data are moved::data are moved
moved between disk::moved between disk
storage and main::storage and main
memory as needed::memory as needed
movement of data::movement of data
disk is slow::disk is slow
central processing unit::central processing unit
database system structure::database system structure
structure the data::structure the data
data between disk::data between disk
disk and main::disk and main
memory the query::memory the query
processor is important::processor is important
helps the database::helps the database
system to simplify::system to simplify
simplify and facilitate::simplify and facilitate
data the query::data the query
processor allows database::processor allows database
users to obtain::users to obtain
obtain good performance::obtain good performance
burdened with understanding::burdened with understanding
understanding the physical-level::understanding the physical-level
system to translate::system to translate
updates and queries::updates and queries
sequence of operations::sequence of operations
level 1.7.1 storage::level 1.7.1 storage
1.7.1 storage manager::1.7.1 storage manager
manager the storage::manager the storage
low-level data stored::low-level data stored
programs and queries::programs and queries
system the storage::system the storage
manager is responsible::manager is responsible
manager the raw::manager the raw
file system provided::file system provided
storage manager translates::storage manager translates
statements into low-level::statements into low-level
low-level file-system commands::low-level file-system commands
file-system commands thesumit67.blogspot.com::file-system commands thesumit67.blogspot.com
responsible for storing::responsible for storing
database the storage::database the storage
storage manager components::storage manager components
manager components include::manager components include
authorization and integrity::authorization and integrity
satisfaction of integrity::satisfaction of integrity
constraints and checks::constraints and checks
checks the authority::checks the authority
authority of users::authority of users
data ? transaction::data ? transaction
state despite system::state despite system
concurrent transaction executions::concurrent transaction executions
transaction executions proceed::transaction executions proceed
proceed without conflicting::proceed without conflicting
conflicting ? file::conflicting ? file
manages the allocation::manages the allocation
allocation of space::allocation of space
space on disk::space on disk
represent information stored::represent information stored
stored on disk::stored on disk
disk ? buffer::disk ? buffer
manager,which is responsible::manager,which is responsible
responsible for fetching::responsible for fetching
data from disk::data from disk
storage into main::storage into main
deciding what data::deciding what data
data to cache::data to cache
cache in main::cache in main
memory the buffer::memory the buffer
enables the database::enables the database
database to handle::database to handle
handle data sizes::handle data sizes
size of main::size of main
memory the storage::memory the storage
storage manager implements::storage manager implements
implements several data::implements several data
structures as part::structures as part
physical system implementation::physical system implementation
store the database::store the database
database ? indices::database ? indices
provide fast access::provide fast access
index provides pointers::index provides pointers
index to find::index to find
find the instructor::find the instructor
alternative to indexing::alternative to indexing
cases we discuss::cases we discuss
discuss storage media::discuss storage media
management in chapter::management in chapter
methods of accessing::methods of accessing
efficiently via indexing::efficiently via indexing
indexing or hashing::indexing or hashing
hashing are discussed::hashing are discussed
1.7.2 the query::1.7.2 the query
processor the query::processor the query
processor components include::processor components include
ddl interpreter,which interprets::ddl interpreter,which interprets
interpreter,which interprets ddl::interpreter,which interprets ddl
interprets ddl statements::interprets ddl statements
statements and records::statements and records
records the definitions::records the definitions
dictionary ? dml::dictionary ? dml
dml compiler,which translates::dml compiler,which translates
compiler,which translates dml::compiler,which translates dml
translates dml statements::translates dml statements
evaluation plan consisting::evaluation plan consisting
consisting of low-level::consisting of low-level
query evaluation engine::query evaluation engine
evaluation engine understands::evaluation engine understands
engine understands thesumit67.blogspot.com::engine understands thesumit67.blogspot.com
introduction a query::introduction a query
number of alternative::number of alternative
alternative evaluation plans::alternative evaluation plans
result the dmlcompiler::result the dmlcompiler
dmlcompiler also performs::dmlcompiler also performs
performs query optimization::performs query optimization
picks the lowest::picks the lowest
lowest cost evaluation::lowest cost evaluation
cost evaluation plan::cost evaluation plan
alternatives ? query::alternatives ? query
executes low-level instructions::executes low-level instructions
low-level instructions generated::low-level instructions generated
dml compiler query::dml compiler query
compiler query evaluation::compiler query evaluation
evaluation is covered::evaluation is covered
covered in chapter::covered in chapter
chapter 12,while themethods::chapter 12,while themethods
bywhich the query::bywhich the query
query optimizer chooses::query optimizer chooses
strategies are discussed::strategies are discussed
form a single::form a single
single logical unit::single logical unit
unit of work::unit of work
transfer must happen::transfer must happen
atomicity in addition::atomicity in addition
funds transfer preserve::funds transfer preserve
preserve the consistency::preserve the consistency
balances of aand::balances of aand
preserved this correctness::preserved this correctness
balances of accounts::balances of accounts
possibility of system::possibility of system
failure this persistence::failure this persistence
durability a transaction::durability a transaction
collection of operations::collection of operations
operations that performs::operations that performs
performs a single::performs a single
single logical function::single logical function
application each transaction::application each transaction
atomicity and consistency::atomicity and consistency
require that transactions::require that transactions
violate any databaseconsistency::violate any databaseconsistency
database was consistent::database was consistent
transaction successfully terminates::transaction successfully terminates
lead to difficulty::lead to difficulty
responsibility to define::responsibility to define
preserves the consistency::preserves the consistency
transaction to transfer::transaction to transfer
account of department::account of department
two separate programs::two separate programs
otherwill indeed preserve::otherwill indeed preserve
transform the database::transform the database
ensuring the atomicity::ensuring the atomicity
atomicity and durability::atomicity and durability
absence of failures::absence of failures
atomicity is achieved::atomicity is achieved
types of failure::types of failure
complete its execution::complete its execution
ensure the atomicity::ensure the atomicity
transaction in question::transaction in question
question started executing::question started executing
executing the database::executing the database
perform failure recovery::perform failure recovery
detect system failures::detect system failures
failures and restore::failures and restore
restore the database::restore the database
update the database::update the database
consistency of data::consistency of data
longer be preserved::longer be preserved
transaction is correct::transaction is correct
manager to control::manager to control
control the interaction::control the interaction
ensure the consistency::ensure the consistency
database the transaction::database the transaction
transaction manager consists::transaction manager consists
manager the basic::manager the basic
concepts of transaction::concepts of transaction
processing are covered::processing are covered
management of concurrent::management of concurrent
transactions is covered::transactions is covered
covers failure recovery::covers failure recovery
recovery in detail::recovery in detail
detail the concept::detail the concept
broadly in database::broadly in database
systems and applications::systems and applications
applications in telecommunication::applications in telecommunication
management of long-duration::management of long-duration
design or administrative::design or administrative
workflows these broader::workflows these broader
concept are discussed::concept are discussed
position to provide::position to provide
provide a single::provide a single
underlying computer system::underlying computer system
database system runs::database system runs
system runs database::system runs database
runs database systems::runs database systems
server machine executes::server machine executes
machine executes work::machine executes work
work on behalf::work on behalf
behalf of multiple::behalf of multiple
multiple client machines::multiple client machines
client machines database::client machines database
machines database systems::machines database systems
designed to exploit::designed to exploit
exploit parallel computer::exploit parallel computer
parallel computer architectures::parallel computer architectures
computer architectures distributed::computer architectures distributed
architectures distributed databases::architectures distributed databases
distributed databases span::distributed databases span
databases span multiple::databases span multiple
multiple geographically separated::multiple geographically separated
geographically separated machines::geographically separated machines
machines in chapter::machines in chapter
cover the general::cover the general
structure of modern::structure of modern
modern computer systems::modern computer systems
computer systems chapter::computer systems chapter
implemented to exploit::implemented to exploit
exploit parallel processing::exploit parallel processing
parallel processing chapter::parallel processing chapter
presents a number::presents a number
number of issues::number of issues
issues that arise::issues that arise
issue the issues::issue the issues
atomicity of transactions::atomicity of transactions
transactions that execute::transactions that execute
execute at multiple::execute at multiple
perform concurrency control::perform concurrency control
provide high availability::provide high availability
presence of failures::presence of failures
failures distributed query::failures distributed query
distributed query processing::distributed query processing
processing and directory::processing and directory
chapter most users::chapter most users
database system today::database system today
differentiate between client::differentiate between client
remote database users::remote database users
database users work::database users work
system runs thesumit67.blogspot.com::system runs thesumit67.blogspot.com
introduction database applications::introduction database applications
invokes database system::invokes database system
database system functionality::database system functionality
machine through naive::machine through naive
query processor storage::query processor storage
processor storage manager::processor storage manager
storage manager disk::storage manager disk
manager disk storage::manager disk storage
disk storage indices::disk storage indices
storage indices data::storage indices data
indices data statistical::indices data statistical
data statistical data::data statistical data
statistical data data::statistical data data
data data dictionary::data data dictionary
data dictionary application::data dictionary application
dictionary application programmers::dictionary application programmers
application programmers application::application programmers application
programmers application interfaces::programmers application interfaces
application interfaces application::application interfaces application
interfaces application program::interfaces application program
application program object::application program object
program object code::program object code
object code compiler::object code compiler
compiler and linker::compiler and linker
linker buffer manager::linker buffer manager
buffer manager file::buffer manager file
manager file manager::manager file manager
file manager authorization::file manager authorization
integrity manager transaction::integrity manager transaction
manager transaction manager::manager transaction manager
transaction manager dml::transaction manager dml
manager dml compiler::manager dml compiler
compiler and organizer::compiler and organizer
organizer query evaluation::organizer query evaluation
evaluation engine dml::evaluation engine dml
engine dml queries::engine dml queries
dml queries ddl::dml queries ddl
queries ddl interpreter::queries ddl interpreter
ddl interpreter application::ddl interpreter application
interpreter application programs::interpreter application programs
application programs query::application programs query
programs query tools::programs query tools
query tools administration::query tools administration
tools administration tools::tools administration tools
administration tools sophisticated::administration tools sophisticated
tools sophisticated users::tools sophisticated users
administrators use write::administrators use write
system structure thesumit67.blogspot.com::system structure thesumit67.blogspot.com
mining and information::mining and information
user application database::user application database
application database system::application database system
database system network::database system network
two-tier architecture client::two-tier architecture client
architecture client server::architecture client server
client server user::client server user
server user application::server user application
user application client::user application client
application client database::application client database
client database system::client database system
system network application::system network application
network application server::network application server
three-tier architecture figure::three-tier architecture figure
two-tier and three-tier::two-tier and three-tier
three-tier architectures query::three-tier architectures query
architectures query language::architectures query language
query language statements::query language statements
language statements application::language statements application
statements application program::statements application program
program interface standards::program interface standards
standards like odbc::standards like odbc
odbc and jdbc::odbc and jdbc
server in contrast::server in contrast
client machine acts::client machine acts
direct database calls::direct database calls
client end communicates::client end communicates
interface the application::interface the application
server in turn::server in turn
system to access::system to access
data the business::data the business
actions to carry::actions to carry
distributed across multiple::distributed across multiple
multiple clients three-tier::multiple clients three-tier
clients three-tier applications::clients three-tier applications
applications that run::applications that run
retrieval the term::retrieval the term
term data mining::term data mining
data mining refers::data mining refers
semiautomatically analyzing large::semiautomatically analyzing large
analyzing large databases::analyzing large databases
databases to find::databases to find
find useful patterns::find useful patterns
patterns like knowledge::patterns like knowledge
discovery in artificial::discovery in artificial
data mining attempts::data mining attempts
attempts to discover::attempts to discover
rules and patterns::rules and patterns
patterns from data::patterns from data
data mining differs::data mining differs
differs from machine::differs from machine
learning and statistics::learning and statistics
deals with large::deals with large
volumes of data::volumes of data
primarily on disk::primarily on disk
data mining deals::data mining deals
discovery in databases::discovery in databases
types of knowledge::types of knowledge
set of rules::set of rules
young womenwith annual::young womenwith annual
womenwith annual incomes::womenwith annual incomes
annual incomes greater::annual incomes greater
people to buy::people to buy
buy small sports::buy small sports
small sports cars::small sports cars
knowledge are represented::knowledge are represented
represented by equations::represented by equations
relating different variables::relating different variables
mechanisms for predicting::mechanisms for predicting
types of patterns::types of patterns
find different types::find different types
patterns in chapter::patterns in chapter
examples of patterns::examples of patterns
component to data::component to data
consisting of preprocessing::consisting of preprocessing
postprocessing of discovered::postprocessing of discovered
patterns to find::patterns to find
type of pattern::type of pattern
needed to pick::needed to pick
pick useful types::pick useful types
process in real::process in real
description we concentrate::description we concentrate
aspect of mining::aspect of mining
businesses have begun::businesses have begun
begun to exploit::begun to exploit
exploit the burgeoning::exploit the burgeoning
burgeoning data online::burgeoning data online
online to make::online to make
make better decisions::make better decisions
items to stock::items to stock
customers to increase::customers to increase
sql several techniques::sql several techniques
techniques and tools::techniques and tools
support several tools::support several tools
tools for data::tools for data
analysis allow analysts::analysis allow analysts
analysts to view::analysts to view
ways other analysis::ways other analysis
analysis tools precompute::analysis tools precompute
tools precompute summaries::tools precompute summaries
amounts of data::amounts of data
order to give::order to give
give fast responses::give fast responses
responses to queries::responses to queries
queries the sql::queries the sql
standard contains additional::standard contains additional
constructs to support::constructs to support
support data analysis::support data analysis
data analysis large::data analysis large
analysis large companies::analysis large companies
companies have diverse::companies have diverse
sources of data::sources of data
making business decisions::making business decisions
decisions to execute::decisions to execute
companies have built::companies have built
built data warehouses::built data warehouses
data warehouses data::data warehouses data
warehouses data warehouses::warehouses data warehouses
warehouses gather data::warehouses gather data
data from multiple::data from multiple
provide the user::provide the user
user a single::user a single
single uniform interface::single uniform interface
interface to data::interface to data
data textual data::data textual data
grown explosively textual::grown explosively textual
explosively textual data::explosively textual data
data is unstructured::data is unstructured
rigidly structured data::rigidly structured data
data in relational::data in relational
relational databases querying::relational databases querying
querying of unstructured::querying of unstructured
unstructured textual data::unstructured textual data
data is referred::data is referred
information retrieval information::information retrieval information
retrieval information retrieval::retrieval information retrieval
information retrieval systems::information retrieval systems
common with database::common with database
storage and retrieval::storage and retrieval
retrieval of data::retrieval of data
data on secondary::data on secondary
field of information::field of information
concentrating on issues::concentrating on issues
based on keywords::based on keywords
relevance of documents::relevance of documents
indexing of documents::indexing of documents
documents in chapters::documents in chapters
cover decision support::cover decision support
including online analytical::including online analytical
online analytical processing::online analytical processing
databases several application::databases several application
areas for database::areas for database
systems are limited::systems are limited
researchers have developed::researchers have developed
developed several datamodels::developed several datamodels
datamodels to deal::datamodels to deal
including object-based data::including object-based data
object-based data models::object-based data models
models and semistructured::models and semistructured
semistructured data models::semistructured data models
data models thesumit67.blogspot.com::data models thesumit67.blogspot.com
users and administrators::users and administrators
1.11.1 object-based data::1.11.1 object-based data
data models object-oriented::data models object-oriented
models object-oriented programming::models object-oriented programming
object identity inheritance::object identity inheritance
methods to provide::methods to provide
provide an interface::provide an interface
interface to objects::interface to objects
concepts of object-oriented::concepts of object-oriented
applications in data::applications in data
modeling the object-oriented::modeling the object-oriented
model also supports::model also supports
supports a rich::supports a rich
rich type system::rich type system
structured and collection::structured and collection
database systems based::database systems based
model were developed::model were developed
developed the major::developed the major
major database vendors::major database vendors
vendors presently support::vendors presently support
support the object-relational::support the object-relational
model that combines::model that combines
datamodel and relational::datamodel and relational
model it extends::model it extends
extends the traditional::extends the traditional
traditional relational model::traditional relational model
variety of features::variety of features
object orientation chapter::object orientation chapter
model 1.11.2 semistructured::model 1.11.2 semistructured
1.11.2 semistructured data::1.11.2 semistructured data
data models semistructured::data models semistructured
models semistructured data::models semistructured data
data models permit::data models permit
permit the specification::permit the specification
attributes the xml::attributes the xml
adding markup information::adding markup information
information to text::information to text
data exchange xml::data exchange xml
deal of flexibility::deal of flexibility
flexibility in structuring::flexibility in structuring
structuring of data::structuring of data
kinds of nontraditional::kinds of nontraditional
nontraditional data chapter::nontraditional data chapter
describes the xml::describes the xml
ways of expressing::ways of expressing
queries on data::queries on data
represented in xml::represented in xml
transforming xml data::transforming xml data
administrators a primary::administrators a primary
store new information::store new information
people who work::people who work
categorized as database::categorized as database
users or database::users or database
administrators 1.12.1 database::administrators 1.12.1 database
1.12.1 database users::1.12.1 database users
users and user::users and user
four different types::four different types
types of database-system::types of database-system
expect to interact::expect to interact
system different types::system different types
types of user::types of user
types of users::types of users
users are unsophisticated::users are unsophisticated
users who interact::users who interact
system by invoking::system by invoking
instructor to thesumit67.blogspot.com::instructor to thesumit67.blogspot.com
department a invokes::department a invokes
invokes a program::invokes a program
hire this program::hire this program
asks the clerk::asks the clerk
salary the typical::salary the typical
typical user interface::typical user interface
user can fill::user can fill
simply read reports::simply read reports
read reports generated::read reports generated
class registration period::class registration period
wishes to register::wishes to register
web application program::web application program
program that runs::program that runs
server the application::server the application
application first verifies::application first verifies
verifies the identity::verifies the identity
access a form::access a form
enters the desired::enters the desired
information the form::information the form
adds the student::adds the student
database ? application::database ? application
programmers are computer::programmers are computer
professionalswho write application::professionalswho write application
write application programs::write application programs
programs application programmers::programs application programmers
programmers can choose::programmers can choose
choose frommany tools::choose frommany tools
tools to develop::tools to develop
develop user interfaces::develop user interfaces
user interfaces rapid::user interfaces rapid
interfaces rapid application::interfaces rapid application
rapid application development::rapid application development
tools are tools::tools are tools
tools that enable::tools that enable
enable an application::enable an application
programmer to construct::programmer to construct
reportswith minimal programming::reportswith minimal programming
minimal programming effort::minimal programming effort
effort ? sophisticated::effort ? sophisticated
sophisticated users interact::sophisticated users interact
system without writing::system without writing
form their requests::form their requests
database query language::database query language
data analysis software::data analysis software
analysis software analysts::analysis software analysts
analysts who submit::analysts who submit
queries to explore::queries to explore
category ? specialized::category ? specialized
users are sophisticated::users are sophisticated
write specialized database::write specialized database
specialized database applications::specialized database applications
traditional data-processing framework::traditional data-processing framework
applications are computer-aided::applications are computer-aided
computer-aided design systems::computer-aided design systems
knowledgebase and expert::knowledgebase and expert
systems that store::systems that store
data with complex::data with complex
complex data types::complex data types
data and audio::data and audio
environment-modeling systems chapter::environment-modeling systems chapter
applications 1.12.2 database::applications 1.12.2 database
1.12.2 database administrator::1.12.2 database administrator
dbmss is tohave::dbmss is tohave
tohave central control::tohave central control
programs that access::programs that access
data a person::data a person
definition the dba::definition the dba
creates the original::creates the original
original database schema::original database schema
schema by executing::schema by executing
executing a set::executing a set
set of data::set of data
data definition statements::data definition statements
ddl ? storage::ddl ? storage
structure and access-method::structure and access-method
definition ? schema::definition ? schema
schema and physical-organization::schema and physical-organization
physical-organization modification thedbacarries::physical-organization modification thedbacarries
schema and physical::schema and physical
organization to reflect::organization to reflect
reflect the changing::reflect the changing
alter the physical::alter the physical
organization to improve::organization to improve
improve performance thesumit67.blogspot.com::improve performance thesumit67.blogspot.com
history of database::history of database
granting of authorization::granting of authorization
authorization for data::authorization for data
access by granting::access by granting
granting different types::granting different types
administrator can regulate::administrator can regulate
regulate which parts::regulate which parts
database various users::database various users
users can access::users can access
access the authorization::access the authorization
special system structure::special system structure
attempts to access::attempts to access
system ? routine::system ? routine
routine maintenance examples::routine maintenance examples
routine maintenance activities::routine maintenance activities
loss of data::loss of data
data in case::data in case
case of disasters::case of disasters
free disk space::free disk space
upgrading disk space::upgrading disk space
space as required::space as required
required monitoring jobs::required monitoring jobs
monitoring jobs running::monitoring jobs running
database and ensuring::database and ensuring
ensuring that performance::ensuring that performance
expensive tasks submitted::expensive tasks submitted
database systems information::database systems information
systems information processing::systems information processing
information processing drives::information processing drives
drives the growth::drives the growth
growth of computers::growth of computers
days of commercial::days of commercial
computers in fact::computers in fact
automation of data::automation of data
data processing tasks::data processing tasks
processing tasks predates::processing tasks predates
tasks predates computers::tasks predates computers
predates computers punched::predates computers punched
computers punched cards::computers punched cards
invented by herman::invented by herman
century to record::century to record
record u.s census::record u.s census
u.s census data::u.s census data
process the cards::process the cards
cards and tabulate::cards and tabulate
tabulate results punched::tabulate results punched
results punched cards::results punched cards
means of entering::means of entering
data into computers::data into computers
techniques for data::techniques for data
storage and processing::storage and processing
processing have evolved::processing have evolved
tapes were developed::tapes were developed
developed for data::developed for data
data storage data::data storage data
storage data processing::storage data processing
payroll were automated::payroll were automated
stored on tapes::stored on tapes
processing of data::processing of data
consisted of reading::consisted of reading
tapes and writing::tapes and writing
input from punched::input from punched
punched card decks::punched card decks
output to printers::output to printers
raises were processed::raises were processed
processed by entering::processed by entering
entering the raises::entering the raises
raises on punched::raises on punched
cards and reading::cards and reading
reading the punched::reading the punched
punched card deck::punched card deck
deck in synchronization::deck in synchronization
tape containing themaster::tape containing themaster
themaster salary details::themaster salary details
details the records::details the records
order the salary::order the salary
master tape tapes::master tape tapes
sizeswere much larger::sizeswere much larger
larger than main::larger than main
data processing programs::data processing programs
programs were forced::programs were forced
forced to process::forced to process
reading and merging::reading and merging
merging data fromtapes::merging data fromtapes
fromtapes and card::fromtapes and card
decks ? late::decks ? late
late 1960s changed::late 1960s changed
changed the scenario::changed the scenario
scenario for data::scenario for data
hard disks allowed::hard disks allowed
disks allowed direct::disks allowed direct
allowed direct access::allowed direct access
data the position::data the position
position of data::position of data
data on disk::data on disk
disk was immaterial::disk was immaterial
location on disk::location on disk
tens of milliseconds::tens of milliseconds
freed from thesumit67.blogspot.com::freed from thesumit67.blogspot.com
introduction the tyranny::introduction the tyranny
tyranny of sequentiality.with::tyranny of sequentiality.with
network and hierarchical::network and hierarchical
created that allowed::created that allowed
allowed data structures::allowed data structures
lists and trees::lists and trees
programmers could construct::programmers could construct
construct and manipulate::construct and manipulate
manipulate these data::manipulate these data
structures a landmark::structures a landmark
paper by codd::paper by codd
defined the relational::defined the relational
model and nonprocedural::model and nonprocedural
ways of querying::ways of querying
relational databaseswere born::relational databaseswere born
born the simplicity::born the simplicity
possibility of hiding::possibility of hiding
hiding implementation details::hiding implementation details
programmer were enticing::programmer were enticing
enticing indeed codd::enticing indeed codd
codd later won::codd later won
won the prestigious::won the prestigious
association of computing::association of computing
computing machinery turing::computing machinery turing
machinery turing award::machinery turing award
perceived performance disadvantages::perceived performance disadvantages
disadvantages ; relational::disadvantages ; relational
databases could notmatch::databases could notmatch
notmatch the performance::notmatch the performance
performance of existing::performance of existing
databases that changed::databases that changed
changed with system::changed with system
project at ibm::project at ibm
research that developed::research that developed
efficient relational database::efficient relational database
relational database system::relational database system
database system excellent::database system excellent
system excellent overviews::system excellent overviews
overviews of system::overviews of system
provided by astrahan::provided by astrahan
fully functional system::fully functional system
system r prototype::system r prototype
led to ibm::led to ibm
first relational database::first relational database
relational database product::relational database product
university of california::university of california
california at berkeley::california at berkeley
berkeley it led::berkeley it led
initial commercial relational::initial commercial relational
played a major::played a major
role in advancing::role in advancing
techniques for efficient::techniques for efficient
processing of declarative::processing of declarative
hierarchical database systems::hierarchical database systems
area of performance::area of performance
performance relational databases::performance relational databases
eventually replaced network::eventually replaced network
databases ; programmers::databases ; programmers
databases were forced::databases were forced
forced to deal::forced to deal
code their queries::code their queries
efficiency in mind::efficiency in mind
mind when designing::mind when designing
designing their programs::designing their programs
involved a lot::involved a lot
lot of effort::lot of effort
effort in contrast::effort in contrast
tasks are carried::tasks are carried
leaving the programmer::leaving the programmer
free to work::free to work
level since attaining::level since attaining
model has reigned::model has reigned
supreme among data::supreme among data
research on parallel::research on parallel
parallel and distributed::parallel and distributed
work on object-oriented::work on object-oriented
language was designed::language was designed
primarily for decision::primarily for decision
decision support applications::decision support applications
mainstay of databases::mainstay of databases
1980s was transaction-processing::1980s was transaction-processing
update-intensive decision support::update-intensive decision support
support and querying::support and querying
major application area::major application area
area for databases::area for databases
tools for analyzing::tools for analyzing
analyzing large amounts::analyzing large amounts
data saw large::data saw large
growths in usage::growths in usage
usage many database::usage many database
database vendors introduced::database vendors introduced
vendors introduced parallel::vendors introduced parallel
introduced parallel database::introduced parallel database
parallel database products::parallel database products
period database vendors::period database vendors
vendors also began::vendors also began
began to add::began to add
add object-relational support::add object-relational support
database-management system::database-management system
interrelated data::interrelated data
information relevant::information relevant
primary goal::primary goal
retrieve database::retrieve database
database information::database information
efficient database::efficient database
database systems::database systems
large bodies::large bodies
information management::information management
data involves::data involves
defining structures::defining structures
providing mechanisms::providing mechanisms
database system::database system
information stored::information stored
system crashes::system crashes
unauthorized access::unauthorized access
anomalous results::anomalous results
computer scientists::computer scientists
large body::large body
managing data::managing data
techniques form::techniques form
database-system applications::database-system applications
applications databases::applications databases
representative applications::representative applications
enterprise information::enterprise information
information sales::information sales
purchase information::purchase information
information accounting::information accounting
account balances::account balances
accounting information::accounting information
information human::information human
human resources::human resources
payroll taxes::payroll taxes
paychecks manufacturing::paychecks manufacturing
supply chain::supply chain
tracking production::tracking production
items inwarehouses::items inwarehouses
introduction online::introduction online
online retailers::online retailers
sales data::sales data
data noted::data noted
online order::online order
order tracking::order tracking
recommendation lists::recommendation lists
online product::online product
product evaluations::product evaluations
finance banking::finance banking
customer information::customer information
banking transactions::banking transactions
transactions credit::transactions credit
credit card::credit card
card transactions::card transactions
credit cards::credit cards
monthly statements::monthly statements
statements finance::statements finance
storing information::storing information
financial instruments::financial instruments
real-time market::real-time market
market data::market data
enable online::enable online
online trading::online trading
automated trading::automated trading
student information::student information
standard enterprise::standard enterprise
schedule information::schedule information
information airlines::information airlines
distributed manner::distributed manner
keeping records::keeping records
calls made::calls made
generating monthly::generating monthly
monthly bills::monthly bills
maintaining balances::maintaining balances
prepaid calling::prepaid calling
calling cards::calling cards
communication networks::communication networks
list illustrates::list illustrates
databases form::databases form
essential part::essential part
enterprise today::enterprise today
twentieth century::twentieth century
databases grewin::databases grewin
early days::early days
people interacted::people interacted
printed reports::printed reports
card statements::card statements
bank tellers::bank tellers
airline reservation::airline reservation
reservation agents::reservation agents
automated teller::automated teller
teller machines::teller machines
users interact::users interact
databases phone::databases phone
phone interfaces::phone interfaces
interactive voice-response::interactive voice-response
voice-response systems::voice-response systems
allowed users::allowed users
press phone::press phone
phone keys::phone keys
enter information::enter information
alternative options::alternative options
find flight::find flight
internet revolution::internet revolution
direct user::direct user
user access::user access
databases organizations::databases organizations
organizations converted::organizations converted
web interfaces::web interfaces
online bookstore::online bookstore
music collection::music collection
accessing data::accessing data
data stored::data stored
order online::order online
bankweb site::bankweb site
bank balance::bank balance
transaction information::transaction information
access aweb::access aweb
aweb site::aweb site
informathesumit67 blogspot.com::informathesumit67 blogspot.com
web accesses::web accesses
user interfaces::user interfaces
interfaces hide::interfaces hide
hide details::hide details
accessing databases::accessing databases
databases forms::databases forms
life today::life today
system vendors::system vendors
largest software::largest software
software companies::software companies
systems form::systems form
important part::important part
product line::product line
systems database::systems database
systems arose::systems arose
early methods::early methods
computerized management::computerized management
commercial data::commercial data
university organization::university organization
operating system::operating system
system files::system files
application programs::application programs
including programs::including programs
register students::register students
generate class::generate class
class rosters::class rosters
assign grades::assign grades
compute grade::compute grade
grade point::grade point
point averages::point averages
generate transcripts::generate transcripts
transcripts system::transcripts system
system programmers::system programmers
programmers wrote::programmers wrote
university decides::university decides
computer science::computer science
university creates::university creates
permanent files::permanent files
adds information::adds information
existing files::existing files
record information::record information
degree requirements::degree requirements
system acquires::system acquires
typical file-processing::typical file-processing
file-processing system::file-processing system
conventional operating::conventional operating
system stores::system stores
stores permanent::stores permanent
permanent records::permanent records
extract records::extract records
add records::add records
database management::database management
management systems::management systems
stored information::stored information
systems keeping::systems keeping
organizational information::organizational information
major disadvantages::major disadvantages
data redundancy::data redundancy
programmers create::programmers create
long period::long period
programming languages::programming languages
double major::double major
telephone number::telephone number
student records::student records
music department::music department
mathematics department::mathematics department
redundancy leads::redundancy leads
higher storage::higher storage
access cost::access cost
data inconsistency::data inconsistency
datamayno longer::datamayno longer
longer agree::longer agree
changed student::changed student
student address::student address
department records::department records
data suppose::data suppose
university clerks::university clerks
postal-code area::postal-code area
clerk asks::clerk asks
data-processing department::data-processing department
original system::original system
application program::application program
university clerk::university clerk
needed information::needed information
unsatisfactory suppose::unsatisfactory suppose
credit hours::credit hours
conventional file-processing::conventional file-processing
file-processing environments::file-processing environments
needed data::needed data
responsive data-retrieval::responsive data-retrieval
data-retrieval systems::data-retrieval systems
data isolation::data isolation
integrity problems::integrity problems
data values::data values
consistency constraints::consistency constraints
constraints suppose::constraints suppose
university maintains::university maintains
balance amount::balance amount
account suppose::account suppose
university requires::university requires
account balance::account balance
developers enforce::developers enforce
compoundedwhen constraints::compoundedwhen constraints
constraints involve::constraints involve
data items::data items
atomicity problems::atomicity problems
computer system::computer system
failure occurs::failure occurs
consistent state::consistent state
system failure::system failure
inconsistent database::inconsistent database
database state::database state
database consistency::database consistency
debit occur::debit occur
funds transfer::funds transfer
ensure atomicity::ensure atomicity
concurrent-access anomalies::concurrent-access anomalies
faster response::faster response
multiple users::multiple users
data simultaneously::data simultaneously
largest internet::largest internet
internet retailers::internet retailers
concurrent updates::concurrent updates
inconsistent data::inconsistent data
department clerks::department clerks
clerks debit::clerks debit
concurrent executions::concurrent executions
state suppose::state suppose
programs executing::programs executing
withdrawal read::withdrawal read
amount beingwithdrawn::amount beingwithdrawn
result back::result back
programs run::programs run
correct value::correct value
coordinated previously::coordinated previously
registration program::registration program
program maintains::program maintains
students registered::students registered
enforce limits::enforce limits
student registers::student registers
program reads::program reads
current count::current count
database suppose::database suppose
program executions::program executions
incorrect increase::incorrect increase
registration limit::registration limit
security problems::security problems
payroll personnel::payroll personnel
financial information::financial information
academic records::academic records
hoc manner::hoc manner
security constraints::security constraints
difficult thesumit67.blogspot.com::difficult thesumit67.blogspot.com
enable database::enable database
file-processing systems::file-processing systems
typical data-processing::typical data-processing
data-processing application::data-processing application
major purpose::major purpose
provide users::provide users
abstract view::abstract view
system hides::system hides
data abstraction::data abstraction
retrieve data::retrieve data
data efficiently::data efficiently
led designers::led designers
complex data::complex data
data structures::data structures
represent data::represent data
database-system users::database-system users
computer trained::computer trained
developers hide::developers hide
simplify users::simplify users
physical level::physical level
lowest level::lowest level
abstraction describes::abstraction describes
level describes::level describes
complex low-level::complex low-level
low-level data::low-level data
logical level::logical level
next-higher level::next-higher level
relationships exist::relationships exist
entire database::entire database
small number::small number
simple structures::simple structures
complex physical-level::complex physical-level
physical-level structures::physical-level structures
physical data::physical data
data independence::data independence
independence database::independence database
database administrators::database administrators
view level::view level
highest level::highest level
simpler structures::simpler structures
complexity remains::complexity remains
large database::large database
abstraction exists::abstraction exists
database figure::database figure
data types::data types
high-level programming::high-level programming
programming thesumit67.blogspot.com::programming thesumit67.blogspot.com
level figure::level figure
abstraction languages::abstraction languages
languages support::languages support
structured type::structured type
type instructor::type instructor
code defines::code defines
record type::record type
record types::record types
student record::student record
consecutive storage::consecutive storage
storage locations::storage locations
compiler hides::compiler hides
lowest-level storage::lowest-level storage
storage details::storage details
database programmers::database programmers
programmers database::programmers database
physical organization::physical organization
actual type::actual type
type declaration::type declaration
declaration depends::declaration depends
struct declarations::struct declarations
declarations java::declarations java
simple class::simple class
effect thesumit67.blogspot.com::effect thesumit67.blogspot.com
type definition::type definition
previous code::previous code
code segment::code segment
programming language::programming language
language work::language work
computer users::computer users
database user::database user
user sees::user sees
hiding details::hiding details
security mechanism::security mechanism
prevent users::prevent users
university registrar::university registrar
registrar office::registrar office
access information::access information
schemas databases::schemas databases
databases change::databases change
database schema::database schema
schema schemas::schema schemas
database schemas::database schemas
program written::program written
programming language.adatabase::programming language.adatabase
language.adatabase schema::language.adatabase schema
schema corresponds::schema corresponds
variable declarations::variable declarations
type definitions::type definitions
schema database::schema database
physical schema::physical schema
schema describes::schema describes
database design::database design
logical schema::logical schema
programmers construct::programmers construct
construct applications::construct applications
hidden beneath::hidden beneath
affecting application::affecting application
programs application::programs application
study languages::study languages
describing schemas::describing schemas
data models::data models
models underlying::models underlying
data model::data model
conceptual tools::conceptual tools
describing data::describing data
data relationships::data relationships
data semantics::data semantics
view levels::view levels
levels thesumit67.blogspot.com::levels thesumit67.blogspot.com
database languages::database languages
relational model::relational model
multiple columns::multiple columns
record-based model::record-based model
record-based models::record-based models
fixed-format records::fixed-format records
type defines::type defines
fixed number::fixed number
table correspond::table correspond
relational data::relational data
vast majority::vast majority
current database::current database
model chapters::model chapters
entity-relationship model::entity-relationship model
basic objects::basic objects
real world::real world
object-based data::object-based data
model.object-oriented programming::model.object-oriented programming
dominant software-development::dominant software-development
software-development methodology::software-development methodology
object-oriented data::object-oriented data
e-r model::e-r model
object identity::object identity
object-relational data::object-relational data
model combines::model combines
combines features::combines features
model chapter::model chapter
semistructured data::semistructured data
model permits::model permits
individual data::individual data
models mentioned::models mentioned
data item::data item
extensible markup::extensible markup
markup language::markup language
data chapter::data chapter
network data::network data
hierarchical data::hierarchical data
model preceded::model preceded
underlying implementation::underlying implementation
modeling data::modeling data
database code::database code
outlined online::outlined online
interested readers::interested readers
data-definition language::data-definition language
data-manipulation language::data-manipulation language
express database::express database
database queries::database queries
upthesumit67 blogspot.com::upthesumit67 blogspot.com
introduction dates::introduction dates
data-manipulation languages::data-manipulation languages
separate languages::separate languages
simply form::simply form
form parts::form parts
single database::single database
database language::database language
sql language::sql language
enables users::enables users
manipulate data::manipulate data
procedural dmls::procedural dmls
dmls require::dmls require
declarative dmls::declarative dmls
nonprocedural dmls::nonprocedural dmls
efficient means::efficient means
statement requesting::statement requesting
involves information::involves information
information retrieval::information retrieval
query language::query language
common practice::common practice
terms query::terms query
language synonymously::language synonymously
database query::database query
query languages::query languages
experimentally.we study::experimentally.we study
structuring data::structuring data
manipulating data::manipulating data
define algorithms::define algorithms
efficient access::efficient access
higher levels::higher levels
emphasize ease::emphasize ease
query processor::query processor
processor component::processor component
translates dml::translates dml
dml queries::dml queries
definitions expressed::definitions expressed
special language::special language
additional properties::additional properties
data thesumit67.blogspot.com::data thesumit67.blogspot.com
storage structure::storage structure
access methods::access methods
special type::special type
data storage::data storage
definition language::definition language
statements define::statements define
implementation details::implementation details
system checks::system checks
arbitrary predicate::arbitrary predicate
predicate pertaining::predicate pertaining
arbitrary predicates::arbitrary predicates
systems implement::systems implement
implement integrity::implement integrity
integrity constraints::integrity constraints
testedwith minimal::testedwith minimal
minimal overhead::minimal overhead
domain constraints::domain constraints
integer types::integer types
character types::character types
domain acts::domain acts
elementary form::elementary form
integrity constraint::integrity constraint
referential integrity::referential integrity
department listed::department listed
department relation::department relation
relation database::relation database
database modifications::database modifications
referential integrity.when::referential integrity.when
referential-integrity constraint::referential-integrity constraint
normal procedure::normal procedure
satisfy domain::satisfy domain
referential-integrity constraints::referential-integrity constraints
special forms::special forms
courses offered::courses offered
system tests::system tests
future modification::future modification
read authorization::read authorization
insert authorization::insert authorization
existing data::existing data
update authorization::update authorization
delete authorization::delete authorization
authorization thesumit67.blogspot.com::authorization thesumit67.blogspot.com
data dictionary,which::data dictionary,which
regular user::regular user
system consults::system consults
actual data::actual data
relational databases::relational databases
relational database::relational database
gentle introduction::gentle introduction
commercial relational::commercial relational
systems employ::systems employ
great detail::great detail
influential languages::influential languages
database comprising::database comprising
shows details::shows details
university instructors::university instructors
university departments::university departments
first table::first table
instructor table::instructor table
instructor named::instructor named
named einstein::named einstein
physics department::physics department
annual salary::annual salary
biology department::biology department
watson building::watson building
real-world university::real-world university
small tables::small tables
illustrate concepts::illustrate concepts
special character::special character
new-line character::new-line character
delimit records::delimit records
model hides::model hides
low-level implementation::low-level implementation
database developers::database developers
create schemas::create schemas
duplicated information::duplicated information
department budget::department budget
instructor record::instructor record
einstein physics::einstein physics
katz comp::katz comp
comp sci::comp sci
kim elec::kim elec
elec eng::elec eng
crick biology::crick biology
srinivasan comp::srinivasan comp
califieri history::califieri history
brandt comp::brandt comp
mozart music::mozart music
gold physics::gold physics
singh finance::singh finance
table dept::table dept
building budget::building budget
budget comp::budget comp
sci taylor::sci taylor
biology watson::biology watson
eng taylor::eng taylor
music packard::music packard
finance painter::finance painter
history painter::history painter
physics watson::physics watson
department table::department table
table figure::table figure
good schema::good schema
schema designs::schema designs
bad schema::bad schema
sql query::sql query
query takes::query takes
single table::single table
history department::history department
select instructor.name::select instructor.name
query specifies::query specifies
table instructor::table instructor
single column::single column
column thesumit67.blogspot.com::column thesumit67.blogspot.com
introduction labeled::introduction labeled
califieri queries::califieri queries
involve information::involve information
query finds::query finds
language sql::language sql
rich ddl::rich ddl
define tables::define tables
sql ddl::sql ddl
ddl statement::ddl statement
statement defines::statement defines
create table::create table
table department::table department
building char::building char
statement creates::statement creates
specific data::specific data
data type::data type
it.we discuss::it.we discuss
discuss data::discuss data
statement updates::statement updates
database access::database access
programs sql::programs sql
universal turing::universal turing
turing machine::turing machine
general-purpose programming::general-purpose programming
sql sql::sql sql
support actions::support actions
host language::host language
embedded sql::embedded sql
sql queries::sql queries
database application::database application
fashion thesumit67.blogspot.com::fashion thesumit67.blogspot.com
university system::university system
calculate student::calculate student
student gpa::student gpa
generate payroll::generate payroll
payroll checks::payroll checks
dml statements::dml statements
program interface::program interface
send dml::send dml
ddl statements::ddl statements
open database::open database
database connectivity::database connectivity
interface standard::interface standard
java database::java database
java language::java language
language syntax::language syntax
embed dml::embed dml
dml calls::dml calls
language program::language program
character prefaces::character prefaces
prefaces dml::prefaces dml
dml precompiler::dml precompiler
procedure calls::procedure calls
design database::design database
end product::end product
database plays::database plays
supporting role::supporting role
role database::role database
complete database::complete database
application environment::application environment
modeled requires::modeled requires
requires attention::requires attention
broader set::broader set
schemas chapter::schemas chapter
application design::application design
design process::design process
high-level data::high-level data
database designerwith::database designerwith
conceptual framework::conceptual framework
data requirements::data requirements
database users::database users
initial phase::initial phase
prospective database::prospective database
database designer::database designer
domain experts::domain experts
user requirements::user requirements
designer chooses::designer chooses
chosen datamodel::chosen datamodel
conceptual schema::conceptual schema
schema developed::schema developed
conceptual-design phase::conceptual-design phase
detailed overview::detailed overview
designer reviews::designer reviews
redundant thesumit67.blogspot.com::redundant thesumit67.blogspot.com
introduction features::introduction features
physical storage::physical storage
conceptual-design process::conceptual-design process
process involves::process involves
involves decisions::involves decisions
business decision::business decision
computer-science problem::computer-science problem
functional requirements::functional requirements
users describe::users describe
operations include::operations include
updating data::updating data
deleting data::deleting data
conceptual design::conceptual design
abstract data::abstract data
database proceeds::database proceeds
final design::final design
design phases::design phases
logical-design phase::logical-design phase
designer maps::designer maps
high-level conceptual::high-level conceptual
implementation data::implementation data
system-specific database::system-specific database
subsequent physical-design::subsequent physical-design
physical-design phase::physical-design phase
physical features::physical features
features include::features include
file organization::file organization
internal storage::internal storage
storage structures::storage structures
initial specification::initial specification
design phase::design phase
phase serves::phase serves
conceptual structure::conceptual structure
major characteristics::major characteristics
major department::major department
total credit::total credit
student earned::student earned
room number::room number
room capacity::room capacity
class meets::class meets
teaching assignments::teaching assignments
real university::real university
university database::university database
preceding design.howeverwe::preceding design.howeverwe
simplified model::simplified model
conceptual ideas::conceptual ideas
complex design::complex design
bank accounts::bank accounts
entities entities::entities entities
attributes dept::attributes dept
form attributes::form attributes
department entity::department entity
entity set::entity set
extra attribute::extra attribute
unique instructor::unique instructor
instructor identifier::instructor identifier
united states::united states
social-security number::social-security number
unique number::unique number
u.s government::u.s government
government assigns::government assigns
unique identifier::unique identifier
identifier arelationship::identifier arelationship
member relationship::member relationship
relationship associates::relationship associates
relationship set::relationship set
logical structure::logical structure
modeling language::modeling language
e-r diagram::e-r diagram
astute reader::astute reader
attribute dept::attribute dept
attributes describing::attributes describing
instructor entity::instructor entity
detailed explanation::detailed explanation
case thesumit67.blogspot.com::case thesumit67.blogspot.com
introduction instructor::introduction instructor
salary department::salary department
department dept_name::department dept_name
dept_name building::dept_name building
budget member::budget member
member figure::member figure
sample e-r::sample e-r
entity sets::entity sets
rectangular box::rectangular box
attributes listed::attributes listed
relationship sets::relationship sets
diamond connecting::diamond connecting
related entity::related entity
database consisting::database consisting
outlined earlier::outlined earlier
relationship member::relationship member
model represents::model represents
important constraint::important constraint
mapping cardinalities::mapping cardinalities
single department::single department
relation schemas::relation schemas
store information::store information
unnecessary redundancy::unnecessary redundancy
retrieve information::retrieve information
information easily::information easily
design schemas::design schemas
normal form::normal form
relation schema::relation schema
desirable normal::desirable normal
normal forms::normal forms
additional information::additional information
real-world enterprise::real-world enterprise
common approach::common approach
functional dependencies::functional dependencies
bad database::bad database
undesirable properties::undesirable properties
bad design::bad design
information thesumit67.blogspot.com::information thesumit67.blogspot.com
salary dept::salary dept
faculty table::faculty table
modified database::modified database
separate tables::separate tables
tables instructor::tables instructor
repeated information::repeated information
alternative design::alternative design
undesirable repeating::undesirable repeating
repeating information::repeating information
information wastes::information wastes
wastes space::wastes space
budget amount::budget amount
original design::original design
single row::single row
alternative database::alternative database
tuple pertaining::tuple pertaining
budget values::budget values
design above,we::design above,we
table require::table require
require values::require values
created department::created department
first instructor::first instructor
null values::null values
null value::null value
unknown value::unknown value
itemof department::itemof department
department information::department information
last instructor::last instructor
department departs::department departs
original database::original database
extensive theory::extensive theory
database designs::database designs
desirable designs::desirable designs
designs chapter::designs chapter
relational-database design::relational-database design
including normalization::including normalization
functional components::functional components
storage manager::storage manager
processor components::processor components
large amount::large amount
storage space::storage space
corporate databases::corporate databases
databases range::databases range
largest databases::largest databases
trillion bytes::trillion bytes
main memory::main memory
disks data::disks data
disk storage::disk storage
slow relative::slow relative
central processing::central processing
processing unit::processing unit
system structure::system structure
move data::move data
facilitate access::facilitate access
good performance::good performance
physical-level details::physical-level details
translate updates::translate updates
queries written::queries written
nonprocedural language::nonprocedural language
efficient sequence::efficient sequence
queries submitted::queries submitted
file manager::file manager
raw data::raw data
file system::file system
system provided::system provided
manager translates::manager translates
low-level file-system::low-level file-system
file-system commands::file-system commands
commands thesumit67.blogspot.com::commands thesumit67.blogspot.com
manager components::manager components
components include::components include
integrity manager::integrity manager
access data::access data
transaction manager::transaction manager
database remains::database remains
system failures::system failures
concurrent transaction::concurrent transaction
transaction executions::transaction executions
executions proceed::executions proceed
represent information::represent information
fetching data::fetching data
buffer manager::buffer manager
critical part::critical part
handle data::handle data
data sizes::data sizes
manager implements::manager implements
physical system::physical system
system implementation::system implementation
data files::data files
stores metadata::stores metadata
fast access::fast access
database index::database index
instructor records::instructor records
discuss storage::discuss storage
storage media::storage media
file structures::file structures
buffer management::buffer management
interpreter,which interprets::interpreter,which interprets
interprets ddl::interprets ddl
data dictionary::data dictionary
compiler,which translates::compiler,which translates
evaluation plan::evaluation plan
plan consisting::plan consisting
low-level instructions::low-level instructions
query evaluation::query evaluation
evaluation engine::evaluation engine
engine understands::engine understands
understands thesumit67.blogspot.com::understands thesumit67.blogspot.com
alternative evaluation::alternative evaluation
evaluation plans::evaluation plans
lowest cost::lowest cost
cost evaluation::cost evaluation
instructions generated::instructions generated
dml compiler::dml compiler
compiler query::compiler query
12,while themethods::12,while themethods
query optimizer::query optimizer
optimizer chooses::optimizer chooses
evaluation strategies::evaluation strategies
transaction management::transaction management
database form::database form
single logical::single logical
logical unit::logical unit
department account::department account
all-or-none requirement::all-or-none requirement
correctness requirement::correctness requirement
successful execution::successful execution
persistence requirement::persistence requirement
logical function::logical function
databaseconsistency constraints::databaseconsistency constraints
transaction started::transaction started
successfully terminates::successfully terminates
temporary inconsistency::temporary inconsistency
transfer funds::transfer funds
separate programs::separate programs
debits account::debits account
credits account::credits account
transactions ensuring::transactions ensuring
durability properties::durability properties
recovery manager::recovery manager
transactions complete::transactions complete
database architecture::database architecture
execution successfully::execution successfully
atomicity property::atomicity property
failed transaction::failed transaction
question started::question started
started executing::started executing
perform failure::perform failure
failure recovery::failure recovery
detect system::detect system
transactions update::transactions update
individual transaction::individual transaction
concurrency-control manager::concurrency-control manager
concurrent transactions::concurrent transactions
manager consists::manager consists
basic concepts::basic concepts
transaction processing::transaction processing
covers failure::covers failure
financial applications::financial applications
real-time applications::real-time applications
long-duration activities::long-duration activities
product design::product design
administrative workflows::administrative workflows
broader applications::broader applications
transaction concept::transaction concept
single picture::single picture
underlying computer::underlying computer
system runs::system runs
runs database::runs database
server machine::server machine
machine executes::machine executes
executes work::executes work
multiple client::multiple client
client machines::client machines
machines database::machines database
parallel computer::parallel computer
computer architectures::computer architectures
architectures distributed::architectures distributed
distributed databases::distributed databases
databases span::databases span
separated machines::separated machines
general structure::general structure
modern computer::modern computer
computer systems::computer systems
systems chapter::systems chapter
query processing::query processing
parallel processing::parallel processing
processing chapter::processing chapter
distributed database::distributed database
issues include::issues include
store data::store data
multiple sites::multiple sites
perform concurrency::perform concurrency
concurrency control::concurrency control
high availability::high availability
failures distributed::failures distributed
distributed query::distributed query
directory systems::directory systems
system today::system today
remote database::remote database
users work::users work
server machines::server machines
runs thesumit67.blogspot.com::runs thesumit67.blogspot.com
introduction database::introduction database
database applications::database applications
two-tier architecture::two-tier architecture
application resides::application resides
client machine::client machine
invokes database::invokes database
system functionality::system functionality
naive users::naive users
web users::web users
processor storage::processor storage
manager disk::manager disk
storage indices::storage indices
indices data::indices data
statistical data::statistical data
data data::data data
dictionary application::dictionary application
application programmers::application programmers
programmers application::programmers application
application interfaces::application interfaces
interfaces application::interfaces application
program object::program object
object code::object code
code compiler::code compiler
linker buffer::linker buffer
manager file::manager file
manager authorization::manager authorization
manager transaction::manager transaction
manager dml::manager dml
organizer query::organizer query
engine dml::engine dml
queries ddl::queries ddl
ddl interpreter::ddl interpreter
interpreter application::interpreter application
programs query::programs query
query tools::query tools
tools administration::tools administration
administration tools::administration tools
tools sophisticated::tools sophisticated
sophisticated users::sophisticated users
structure thesumit67.blogspot.com::structure thesumit67.blogspot.com
data mining::data mining
user application::user application
application database::application database
system network::system network
architecture client::architecture client
client server::client server
server user::server user
application client::application client
client database::client database
network application::network application
application server::application server
three-tier architecture::three-tier architecture
architecture figure::architecture figure
three-tier architectures::three-tier architectures
architectures query::architectures query
language statements::language statements
statements application::statements application
interface standards::interface standards
machine acts::machine acts
front end::front end
direct database::direct database
database calls::database calls
client end::client end
end communicates::end communicates
forms interface::forms interface
turn communicates::turn communicates
business logic::business logic
multiple clients::multiple clients
clients three-tier::clients three-tier
three-tier applications::three-tier applications
large applications::large applications
term data::term data
mining refers::mining refers
large databases::large databases
knowledge discovery::knowledge discovery
artificial intelligence::artificial intelligence
machine learning::machine learning
statistical analysis::statistical analysis
mining attempts::mining attempts
discover rules::discover rules
mining differs::mining differs
large volumes::large volumes
mining deals::mining deals
knowledge discovered::knowledge discovered
young womenwith::young womenwith
annual incomes::annual incomes
small sports::small sports
sports cars::sports cars
introduction degrees::introduction degrees
equations relating::equations relating
predicting outcomes::predicting outcomes
manual component::manual component
preprocessing data::preprocessing data
discovered patterns::discovered patterns
manual interaction::manual interaction
semiautomatic process::semiautomatic process
real life::real life
automatic aspect::automatic aspect
mining businesses::mining businesses
burgeoning data::burgeoning data
data online::data online
target customers::target customers
increase sales::increase sales
decision support::decision support
data analysis::data analysis
view data::view data
analysis tools::analysis tools
tools precompute::tools precompute
precompute summaries::precompute summaries
large amounts::large amounts
fast responses::fast responses
sql standard::sql standard
additional constructs::additional constructs
support data::support data
large companies::large companies
diverse sources::diverse sources
making business::making business
business decisions::business decisions
execute queries::execute queries
diverse data::diverse data
built data::built data
data warehouses::data warehouses
warehouses data::warehouses data
gather data::gather data
multiple sources::multiple sources
unified schema::unified schema
single site::single site
single uniform::single uniform
uniform interface::uniform interface
textual data::textual data
grown explosively::grown explosively
structured data::structured data
databases querying::databases querying
retrieval information::retrieval information
retrieval systems::retrieval systems
secondary storage::secondary storage
information systems::information systems
querying based::querying based
cover decision::cover decision
including online::including online
analytical processing::analytical processing
data warehousing::data warehousing
specialty databases::specialty databases
application areas::application areas
application domains::application domains
models thesumit67.blogspot.com::models thesumit67.blogspot.com
object-oriented programming::object-oriented programming
identity inheritance::identity inheritance
information hiding::information hiding
key concepts::key concepts
found applications::found applications
data modeling::data modeling
rich type::rich type
type system::type system
collection types::collection types
systems based::systems based
major database::major database
database vendors::database vendors
presently support::presently support
object-oriented datamodel::object-oriented datamodel
traditional relational::traditional relational
object orientation::object orientation
orientation chapter::orientation chapter
models semistructured::models semistructured
models permit::models permit
xml language::xml language
adding markup::adding markup
markup information::markup information
text documents::text documents
data exchange::data exchange
exchange xml::exchange xml
nested structure::nested structure
great deal::great deal
nontraditional data::nontraditional data
expressing queries::expressing queries
data represented::data represented
transforming xml::transforming xml
xml data::xml data
database people::database people
unsophisticated users::unsophisticated users
written previously::written previously
introduction department::introduction department
program asks::program asks
typical user::typical user
user interface::user interface
read reports::read reports
reports generated::reports generated
class registration::class registration
registration period::registration period
web interface::web interface
user connects::user connects
web application::web application
web server::web server
desired information::desired information
form information::form information
retrieving information::retrieving information
class roster::class roster
write application::write application
choose frommany::choose frommany
frommany tools::frommany tools
develop user::develop user
interfaces rapid::interfaces rapid
rapid application::rapid application
application development::application development
application programmer::application programmer
construct forms::construct forms
minimal programming::minimal programming
programming effort::programming effort
writing programs::writing programs
analysis software::analysis software
software analysts::software analysts
submit queries::submit queries
explore data::explore data
database fall::database fall
specialized users::specialized users
specialized database::specialized database
traditional data-processing::traditional data-processing
data-processing framework::data-processing framework
computer-aided design::computer-aided design
design systems::design systems
expert systems::expert systems
graphics data::graphics data
audio data::audio data
environment-modeling systems::environment-modeling systems
database administrator::database administrator
main reasons::main reasons
tohave central::tohave central
central control::central control
dba include::dba include
schema definition::schema definition
dba creates::dba creates
data definition::data definition
definition statements::definition statements
access-method definition::access-method definition
physical-organization modification::physical-organization modification
modification thedbacarries::modification thedbacarries
improve performance::improve performance
performance thesumit67.blogspot.com::performance thesumit67.blogspot.com
data access::data access
authorization information::authorization information
special system::special system
routine maintenance::routine maintenance
maintenance examples::maintenance examples
maintenance activities::maintenance activities
remote servers::remote servers
prevent loss::prevent loss
flooding ensuring::flooding ensuring
free disk::free disk
disk space::disk space
normal operations::normal operations
upgrading disk::upgrading disk
required monitoring::required monitoring
monitoring jobs::monitoring jobs
jobs running::jobs running
expensive tasks::expensive tasks
tasks submitted::tasks submitted
systems information::systems information
information processing::information processing
processing drives::processing drives
earliest days::earliest days
commercial computers::commercial computers
data processing::data processing
processing tasks::processing tasks
tasks predates::tasks predates
predates computers::predates computers
computers punched::computers punched
punched cards::punched cards
record u.s::record u.s
u.s census::u.s census
census data::census data
mechanical systemswere::mechanical systemswere
tabulate results::tabulate results
results punched::results punched
entering data::entering data
computers techniques::computers techniques
magnetic tapes::magnetic tapes
storage data::storage data
tapes processing::tapes processing
data consisted::data consisted
reading data::reading data
writing data::writing data
tape data::tape data
punched card::punched card
card decks::card decks
salary raises::salary raises
card deck::card deck
themaster salary::themaster salary
salary details::salary details
sorted order::sorted order
salary read::salary read
master tape::master tape
tape tapes::tape tapes
processing programs::processing programs
process data::process data
merging data::merging data
data fromtapes::data fromtapes
hard disks::hard disks
disks allowed::disks allowed
direct access::direct access
milliseconds data::milliseconds data
sequentiality.with disks::sequentiality.with disks
hierarchical databases::hierarchical databases
allowed data::allowed data
disk programmers::disk programmers
landmark paper::landmark paper
nonprocedural ways::nonprocedural ways
querying data::querying data
relational databaseswere::relational databaseswere
databaseswere born::databaseswere born
hiding implementation::hiding implementation
prestigious association::prestigious association
computing machinery::computing machinery
machinery turing::machinery turing
turing award::turing award
perceived performance::perceived performance
performance disadvantages::performance disadvantages
existing network::existing network
groundbreaking project::groundbreaking project
ibm research::ibm research
developed techniques::developed techniques
efficient relational::efficient relational
system excellent::system excellent
excellent overviews::excellent overviews
functional system::functional system
prototype led::prototype led
database product::database product
ingres system::ingres system
commercial product::commercial product
initial commercial::initial commercial
ibm db2::ibm db2
dec rdb::dec rdb
major role::major role
advancing techniques::advancing techniques
efficient processing::efficient processing
declarative queries::declarative queries
competitivewith network::competitivewith network
hierarchical database::hierarchical database
replaced network::replaced network
procedural fashion::procedural fashion
low-level tasks::low-level tasks
attaining dominance::attaining dominance
reigned supreme::reigned supreme
initial work::initial work
object-oriented databases::object-oriented databases
support applications::support applications
transaction-processing applications::transaction-processing applications
update-intensive decision::update-intensive decision
major application::major application
application area::application area
databases tools::databases tools
large growths::large growths
vendors introduced::vendors introduced
parallel database::parallel database
database products::database products
period database::period database
object-relational support::object-relational support
database-management::database-management
system::system
dbms::dbms
collection::collection
interrelated::interrelated
data::data
set::set
programs::programs
access::access
referred::referred
database::database
information::information
relevant::relevant
enterprise::enterprise
primary::primary
goal::goal
provide::provide
store::store
retrieve::retrieve
convenient::convenient
efficient::efficient
systems::systems
designed::designed
manage::manage
large::large
bodies::bodies
management::management
involves::involves
defining::defining
structures::structures
storage::storage
providing::providing
mechanisms::mechanisms
manipulation::manipulation
addition::addition
ensure::ensure
safety::safety
stored::stored
crashes::crashes
attempts::attempts
unauthorized::unauthorized
shared::shared
users::users
avoid::avoid
anomalous::anomalous
results::results
important::important
organizations::organizations
computer::computer
scientists::scientists
developed::developed
body::body
concepts::concepts
techniques::techniques
managing::managing
form::form
focus::focus
book::book
chapter::chapter
briefly::briefly
introduces::introduces
principles::principles
database-system::database-system
applications::applications
databases::databases
widely::widely
representative::representative
sales::sales
customer::customer
product::product
purchase::purchase
accounting::accounting
payments::payments
receipts::receipts
account::account
balances::balances
assets::assets
human::human
resources::resources
employees::employees
salaries::salaries
payroll::payroll
taxes::taxes
benefits::benefits
generation::generation
paychecks::paychecks
manufacturing::manufacturing
supply::supply
chain::chain
tracking::tracking
production::production
items::items
factories::factories
inventories::inventories
inwarehouses::inwarehouses
stores::stores
orders::orders
thesumit67.blogspot.com::thesumit67.blogspot.com
introduction::introduction
online::online
retailers::retailers
noted::noted
order::order
recommendation::recommendation
lists::lists
maintenance::maintenance
evaluations::evaluations
banking::banking
finance::finance
accounts::accounts
loans::loans
transactions::transactions
credit::credit
card::card
purchases::purchases
cards::cards
monthly::monthly
statements::statements
storing::storing
holdings::holdings
financial::financial
instruments::instruments
stocks::stocks
bonds::bonds
real-time::real-time
market::market
enable::enable
trading::trading
customers::customers
automated::automated
firm::firm
universities::universities
student::student
registrations::registrations
grades::grades
standard::standard
airlines::airlines
reservations::reservations
schedule::schedule
first::first
geographically::geographically
distributed::distributed
manner::manner
telecommunication::telecommunication
keeping::keeping
records::records
calls::calls
made::made
generating::generating
bills::bills
maintaining::maintaining
prepaid::prepaid
calling::calling
communication::communication
networks::networks
list::list
illustrates::illustrates
essential::essential
part::part
today::today
types::types
common::common
enterprises::enterprises
specific::specific
category::category
last::last
four::four
decades::decades
twentieth::twentieth
century::century
grewin::grewin
early::early
days::days
people::people
interacted::interacted
directly::directly
realizing::realizing
indirectly::indirectly
printed::printed
reports::reports
agents::agents
bank::bank
tellers::tellers
airline::airline
reservation::reservation
teller::teller
machines::machines
interact::interact
phone::phone
interfaces::interfaces
computers::computers
interactive::interactive
voice-response::voice-response
allowed::allowed
deal::deal
caller::caller
dial::dial
number::number
press::press
keys::keys
enter::enter
select::select
alternative::alternative
options::options
find::find
flight::flight
times::times
register::register
courses::courses
university::university
internet::internet
revolution::revolution
late::late
1990s::1990s
sharply::sharply
increased::increased
direct::direct
user::user
converted::converted
web::web
variety::variety
services::services
instance::instance
bookstore::bookstore
browse::browse
music::music
accessing::accessing
database.when::database.when
bankweb::bankweb
site::site
balance::balance
transaction::transaction
retrieved::retrieved
system.when::system.when
aweb::aweb
informathesumit67::informathesumit67
blogspot.com::blogspot.com
purpose::purpose
tion::tion
advertisements::advertisements
accesses::accesses
hide::hide
details::details
aware::aware
dealing::dealing
forms::forms
life::life
importance::importance
judged::judged
vendors::vendors
oracle::oracle
largest::largest
software::software
companies::companies
world::world
line::line
microsoft::microsoft
ibm::ibm
arose::arose
response::response
methods::methods
computerized::computerized
commercial::commercial
typical::typical
1960s::1960s
organization::organization
instructors::instructors
students::students
departments::departments
offerings::offerings
operating::operating
files::files
manipulate::manipulate
application::application
including::including
add::add
generate::generate
class::class
rosters::rosters
assign::assign
compute::compute
grade::grade
point::point
averages::averages
gpa::gpa
transcripts::transcripts
programmers::programmers
wrote::wrote
meet::meet
added::added
arises::arises
suppose::suppose
decides::decides
create::create
major::major
science::science
.as::.as
result::result
creates::creates
newdepartment::newdepartment
permanent::permanent
adds::adds
existing::existing
record::record
department::department
degree::degree
requirements::requirements
write::write
rules::rules
written::written
handle::handle
acquires::acquires
file-processing::file-processing
supported::supported
conventional::conventional
extract::extract
dbmss::dbmss
introduced::introduced
organizational::organizational
disadvantages::disadvantages
redundancy::redundancy
inconsistency::inconsistency
long::long
period::period
bewritten::bewritten
programming::programming
languages::languages
duplicated::duplicated
places::places
double::double
mathematics::mathematics
address::address
telephone::telephone
file::file
consists::consists
leads::leads
higher::higher
cost::cost
lead::lead
copies::copies
datamayno::datamayno
longer::longer
agree::agree
changed::changed
reflected::reflected
difficulty::difficulty
clerks::clerks
out::out
names::names
live::live
postal-code::postal-code
area::area
clerk::clerk
asks::asks
data-processing::data-processing
designers::designers
original::original
anticipate::anticipate
request::request
program::program
hand::hand
two::two
choices::choices
obtain::obtain
needed::needed
manually::manually
programmer::programmer
alternatives::alternatives
unsatisfactory::unsatisfactory
trim::trim
include::include
hours::hours
expected::expected
exist::exist
preceding::preceding
satisfactory::satisfactory
environments::environments
efficientmanner::efficientmanner
responsive::responsive
data-retrieval::data-retrieval
required::required
general::general
isolation::isolation
scattered::scattered
formats::formats
writing::writing
difficult::difficult
integrity::integrity
problems::problems
values::values
satisfy::satisfy
consistency::consistency
constraints::constraints
maintains::maintains
amount::amount
requires::requires
fall::fall
developers::developers
enforce::enforce
adding::adding
code::code
change::change
problem::problem
compoundedwhen::compoundedwhen
involve::involve
atomicity::atomicity
device::device
subject::subject
failure::failure
crucial::crucial
occurs::occurs
restored::restored
consistent::consistent
state::state
existed::existed
prior::prior
transfer::transfer
execution::execution
removed::removed
butwas::butwas
credited::credited
resulting::resulting
inconsistent::inconsistent
debit::debit
occur::occur
funds::funds
atomic::atomic
happen::happen
entirety::entirety
concurrent-access::concurrent-access
anomalies::anomalies
sake::sake
performance::performance
faster::faster
multiple::multiple
update::update
simultaneously::simultaneously
millions::millions
day::day
shoppers::shoppers
environment::environment
interaction::interaction
concurrent::concurrent
updates::updates
10,000::10,000
executions::executions
leave::leave
budget::budget
incorrect::incorrect
executing::executing
behalf::behalf
withdrawal::withdrawal
read::read
reduce::reduce
value::value
beingwithdrawn::beingwithdrawn
back::back
run::run
concurrently::concurrently
depending::depending
writes::writes
correct::correct
guard::guard
possibility::possibility
maintain::maintain
supervision::supervision
accessed::accessed
coordinated::coordinated
previously::previously
registration::registration
count::count
registered::registered
limits::limits
registered.when::registered.when
registers::registers
reads::reads
current::current
verifies::verifies
limit::limit
leading::leading
increase::increase
successfully::successfully
case::case
violation::violation
security::security
personnel::personnel
academic::academic
hoc::hoc
enforcing::enforcing
difficulties::difficulties
prompted::prompted
development::development
algorithms::algorithms
solve::solve
running::running
view::view
modify::modify
abstract::abstract
hides::hides
maintained::maintained
1.3.1::1.3.1
abstraction::abstraction
usable::usable
efficiently::efficiently
efficiency::efficiency
led::led
complex::complex
represent::represent
trained::trained
complexity::complexity
levels::levels
simplify::simplify
interactions::interactions
physical::physical
level::level
lowest::lowest
describes::describes
low-level::low-level
detail::detail
logical::logical
next-higher::next-higher
relationships::relationships
entire::entire
terms::terms
small::small
simple::simple
implementation::implementation
physical-level::physical-level
independence::independence
administrators::administrators
decide::decide
highest::highest
simpler::simpler
remains::remains
exists::exists
views::views
figure::figure
shows::shows
relationship::relationship
analogy::analogy
concept::concept
clarify::clarify
distinction::distinction
high-level::high-level
support::support
notion::notion
structured::structured
type::type
describe::describe
instructor::instructor
char::char
dept::dept
salary::salary
numeric::numeric
8,2::8,2
end::end
defines::defines
fields::fields
field::field
building::building
title::title
credits::credits
tot::tot
cred::cred
described::described
block::block
consecutive::consecutive
locations::locations
compiler::compiler
similarly::similarly
lowest-level::lowest-level
1the::1the
actual::actual
declaration::declaration
depends::depends
language::language
struct::struct
declarations::declarations
java::java
defined::defined
effect::effect
definition::definition
previous::previous
segment::segment
interrelationship::interrelationship
work::work
finally::finally
sees::sees
hiding::hiding
mechanism::mechanism
prevent::prevent
parts::parts
registrar::registrar
office::office
1.3.2::1.3.2
instances::instances
schemas::schemas
inserted::inserted
deleted::deleted
moment::moment
design::design
schema::schema
infrequently::infrequently
understood::understood
language.adatabase::language.adatabase
corresponds::corresponds
variable::variable
definitions::definitions
instant::instant
variables::variables
correspond::correspond
partitioned::partitioned
subschemas::subschemas
construct::construct
hidden::hidden
beneath::beneath
easily::easily
affecting::affecting
exhibit::exhibit
depend::depend
rewritten::rewritten
study::study
describing::describing
introducing::introducing
models::models
section::section
1.3.3::1.3.3
underlying::underlying
structure::structure
model::model
conceptual::conceptual
tools::tools
semantics::semantics
cover::cover
text::text
classified::classified
categories::categories
relational::relational
tables::tables
table::table
columns::columns
column::column
unique::unique
relations::relations
record-based::record-based
named::named
fixed-format::fixed-format
fixed::fixed
attributes::attributes
vast::vast
majority::majority
based::based
chapters::chapters
entity-relationship::entity-relationship
e-r::e-r
basic::basic
objects::objects
entities::entities
andrelationships::andrelationships
entity::entity
thing::thing
object::object
real::real
distinguishable::distinguishable
explores::explores
object-based::object-based
model.object-oriented::model.object-oriented
dominant::dominant
software-development::software-development
methodology::methodology
object-oriented::object-oriented
extending::extending
notions::notions
encapsulation::encapsulation
functions::functions
identity::identity
object-relational::object-relational
combines::combines
features::features
examines::examines
semistructured::semistructured
permits::permits
specification::specification
individual::individual
sets::sets
contrast::contrast
mentioned::mentioned
earlier::earlier
item::item
extensible::extensible
markup::markup
xml::xml
covers::covers
historically::historically
network::network
hierarchical::hierarchical
preceded::preceded
modelswere::modelswere
tied::tied
closely::closely
complicated::complicated
task::task
modeling::modeling
service::service
outlined::outlined
appendices::appendices
interested::interested
readers::readers
data-definition::data-definition
data-manipulation::data-manipulation
express::express
queries::queries
upthesumit67::upthesumit67
dates::dates
practice::practice
separate::separate
simply::simply
single::single
sql::sql
1.4.1::1.4.1
dml::dml
enables::enables
organized::organized
retrieval::retrieval
insertion::insertion
deletion::deletion
modification::modification
basically::basically
procedural::procedural
dmls::dmls
require::require
declarative::declarative
nonprocedural::nonprocedural
easier::easier
learn::learn
means::means
query::query
statement::statement
requesting::requesting
portion::portion
technically::technically
synonymously::synonymously
commercially::commercially
experimentally.we::experimentally.we
inchapters::inchapters
discussed::discussed
apply::apply
structuring::structuring
manipulating::manipulating
define::define
emphasize::emphasize
ease::ease
humans::humans
processor::processor
component::component
translates::translates
sequences::sequences
actions::actions
1.4.2::1.4.2
expressed::expressed
special::special
ddl::ddl
additional::additional
properties::properties
negative::negative
facilities::facilities
checks::checks
updated::updated
constraint::constraint
arbitrary::arbitrary
predicate::predicate
pertaining::pertaining
database.however::database.however
predicates::predicates
costly::costly
test::test
implement::implement
testedwith::testedwith
minimal::minimal
overhead::overhead
domain::domain
attribute::attribute
integer::integer
character::character
declaring::declaring
acts::acts
elementary::elementary
tested::tested
entered::entered
referential::referential
cases::cases
appears::appears
relation::relation
listed::listed
precisely::precisely
modifications::modifications
violations::violations
integrity.when::integrity.when
referential-integrity::referential-integrity
violated::violated
normal::normal
procedure::procedure
reject::reject
action::action
caused::caused
assertions::assertions
assertion::assertion
condition::condition
offered::offered
semester::semester
created::created
tests::tests
validity::validity
valid::valid
future::future
authorization::authorization
differentiate::differentiate
permitted::permitted
differentiations::differentiations
reading::reading
insert::insert
delete::delete
combination::combination
input::input
instructions::instructions
generates::generates
output::output
dictionary,which::dictionary,which
metadata::metadata
dictionary::dictionary
considered::considered
regular::regular
consults::consults
modifying::modifying
includes::includes
present::present
gentle::gentle
fundamentals::fundamentals
employ::employ
great::great
discuss::discuss
influential::influential
1.5.1::1.5.1
presents::presents
sample::sample
comprising::comprising
einstein::einstein
member::member
physics::physics
annual::annual
95,000::95,000
biology::biology
located::located
watson::watson
90,000::90,000
real-world::real-world
illustrate::illustrate
larger::larger
hard::hard
delimit::delimit
new-line::new-line
note::note
unnecessarily::unnecessarily
history::history
katz::katz
comp::comp
sci::sci
kim::kim
elec::elec
eng::eng
crick::crick
srinivasan::srinivasan
califieri::califieri
brandt::brandt
mozart::mozart
gold::gold
singh::singh
taylor::taylor
packard::packard
painter::painter
distinguish::distinguish
good::good
designs::designs
bad::bad
1.5.2::1.5.2
takes::takes
possibly::possibly
returns::returns
finds::finds
instructor.name::instructor.name
instructor.dept::instructor.dept
specifies::specifies
rows::rows
fromthe::fromthe
historymust::historymust
displayed::displayed
specifically::specifically
labeled::labeled
consist::consist
greater::greater
instructor.id::instructor.id
department.dept::department.dept
department.budget::department.budget
1.5.3::1.5.3
rich::rich
12,2::12,2
it.we::it.we
1.5.4::1.5.4
powerful::powerful
universal::universal
turing::turing
machine::machine
computations::computations
general-purpose::general-purpose
displays::displays
host::host
embedded::embedded
fashion::fashion
examples::examples
calculate::calculate
executed::executed
ways::ways
interface::interface
procedures::procedures
send::send
open::open
connectivity::connectivity
odbc::odbc
commonly::commonly
jdbc::jdbc
syntax::syntax
embed::embed
prefaces::prefaces
preprocessor::preprocessor
precompiler::precompiler
converts::converts
operation::operation
plays::plays
supporting::supporting
role::role
complete::complete
meets::meets
modeled::modeled
attention::attention
broader::broader
issues::issues
initially::initially
discusses::discusses
process::process
1.6.1::1.6.1
designerwith::designerwith
framework::framework
fulfill::fulfill
initial::initial
phase::phase
characterize::characterize
fully::fully
prospective::prospective
designer::designer
extensively::extensively
experts::experts
carry::carry
outcome::outcome
chooses::chooses
applying::applying
chosen::chosen
datamodel::datamodel
conceptual-design::conceptual-design
detailed::detailed
overview::overview
reviews::reviews
confirm::confirm
satisfied::satisfied
conflict::conflict
examine::examine
remove::remove
redundant::redundant
decisions::decisions
capture::capture
group::group
business::business
decision::decision
computer-science::computer-science
principally::principally
tackle::tackle
1.6.3::1.6.3
collectively::collectively
normalization::normalization
1.6.4::1.6.4
functional::functional
kinds::kinds
operations::operations
performed::performed
updating::updating
searching::searching
retrieving::retrieving
deleting::deleting
stage::stage
review::review
moving::moving
proceeds::proceeds
final::final
phases::phases
logical-design::logical-design
maps::maps
system-specific::system-specific
subsequent::subsequent
physical-design::physical-design
internal::internal
1.6.2::1.6.2
interviews::interviews
analysis::analysis
description::description
serves::serves
basis::basis
characteristics::characteristics
identified::identified
offers::offers
prerequisites::prerequisites
total::total
earned::earned
classrooms::classrooms
room::room
capacity::capacity
classes::classes
sections::sections
taught::taught
sec::sec
year::year
slot::slot
teaching::teaching
assignments::assignments
design.howeverwe::design.howeverwe
simplified::simplified
understand::understand
ideas::ideas
lost::lost
person::person
entity.2::entity.2
extra::extra
identify::identify
uniquely::uniquely
identifier::identifier
assigned::assigned
united::united
states::states
social-security::social-security
u.s::u.s
government::government
assigns::assigns
arelationship::arelationship
association::association
associates::associates
termed::termed
graphically::graphically
diagram::diagram
draw::draw
diagrams::diagrams
popular::popular
unified::unified
uml::uml
notation::notation
represented::represented
2the::2the
astute::astute
reader::reader
notice::notice
dropped::dropped
error::error
explanation::explanation
dept_name::dept_name
rectangular::rectangular
box::box
header::header
diamond::diamond
connecting::connecting
pair::pair
related::related
inside::inside
illustration::illustration
consisting::consisting
represents::represents
contents::contents
conform::conform
mapping::mapping
cardinalities::cardinalities
iswidely::iswidely
method::method
designing::designing
unnecessary::unnecessary
approach::approach
determine::determine
desirable::desirable
dependencies::dependencies
wrong::wrong
undesirable::undesirable
repetition::repetition
inability::inability
faculty::faculty
modified::modified
shown::shown
repeated::repeated
repeating::repeating
wastes::wastes
space::space
complicates::complicates
50,000::50,000
46,800::46,800
row::row
perform::perform
tuple::tuple
show::show
shift::shift
issue::issue
creating::creating
above,we::above,we
newly::newly
hired::hired
solution::solution
introduce::introduce
null::null
unknown::unknown
missing::missing
preferable::preferable
resort::resort
itemof::itemof
departs::departs
situation::situation
resorting::resorting
extensive::extensive
theory::theory
helps::helps
formally::formally
relational-database::relational-database
querying::querying
modules::modules
responsibilities::responsibilities
components::components
broadly::broadly
divided::divided
manager::manager
typically::typically
corporate::corporate
range::range
size::size
hundreds::hundreds
gigabytes::gigabytes
terabytes::terabytes
gigabyte::gigabyte
approximately::approximately
megabytes::megabytes
billion::billion
bytes::bytes
terabyte::terabyte
million::million
trillion::trillion
main::main
memory::memory
disks::disks
moved::moved
disk::disk
movement::movement
slow::slow
relative::relative
speed::speed
central::central
processing::processing
unit::unit
imperative::imperative
minimize::minimize
move::move
facilitate::facilitate
burdened::burdened
understanding::understanding
job::job
translate::translate
sequence::sequence
1.7.1::1.7.1
submitted::submitted
responsible::responsible
raw::raw
provided::provided
file-system::file-system
commands::commands
satisfaction::satisfaction
authority::authority
ensures::ensures
failures::failures
proceed::proceed
conflicting::conflicting
manages::manages
allocation::allocation
buffer::buffer
manager,which::manager,which
fetching::fetching
deciding::deciding
cache::cache
critical::critical
sizes::sizes
implements::implements
indices::indices
fast::fast
index::index
textbook::textbook
pointers::pointers
hold::hold
hashing::hashing
indexing::indexing
media::media
1.7.2::1.7.2
interpreter,which::interpreter,which
interprets::interprets
compiler,which::compiler,which
evaluation::evaluation
plan::plan
engine::engine
understands::understands
translated::translated
plans::plans
give::give
dmlcompiler::dmlcompiler
performs::performs
optimization::optimization
picks::picks
executes::executes
generated::generated
covered::covered
12,while::12,while
themethods::themethods
bywhich::bywhich
optimizer::optimizer
strategies::strategies
debited::debited
all-or-none::all-or-none
requirement::requirement
preserve::preserve
sum::sum
aand::aand
preserved::preserved
correctness::correctness
successful::successful
persist::persist
persistence::persistence
durability::durability
function::function
violate::violate
databaseconsistency::databaseconsistency
started::started
terminates::terminates
temporarily::temporarily
done::done
temporary::temporary
responsibility::responsibility
properly::properly
preserves::preserves
composed::composed
debits::debits
otherwill::otherwill
consistency.however::consistency.however
transform::transform
ensuring::ensuring
recovery::recovery
absence::absence
achieved::achieved
architecture::architecture
property::property
failed::failed
question::question
detect::detect
restore::restore
occurrence::occurrence
concurrency-control::concurrency-control
control::control
applied::applied
long-duration::long-duration
activities::activities
administrative::administrative
workflows::workflows
position::position
picture::picture
connections::connections
greatly::greatly
influenced::influenced
runs::runs
centralized::centralized
client-server::client-server
server::server
client::client
exploit::exploit
parallel::parallel
architectures::architectures
span::span
separated::separated
modern::modern
implemented::implemented
arise::arise
execute::execute
sites::sites
concurrency::concurrency
high::high
availability::availability
presence::presence
directory::directory
connect::connect
remote::remote
two-tier::two-tier
resides::resides
invokes::invokes
functionality::functionality
naive::naive
statistical::statistical
linker::linker
organizer::organizer
interpreter::interpreter
administration::administration
sophisticated::sophisticated
analysts::analysts
mining::mining
three-tier::three-tier
standards::standards
front::front
communicates::communicates
turn::turn
logic::logic
conditions::conditions
clients::clients
worldwideweb::worldwideweb
term::term
refers::refers
loosely::loosely
semiautomatically::semiautomatically
analyzing::analyzing
patterns::patterns
knowledge::knowledge
discovery::discovery
artificial::artificial
intelligence::intelligence
learning::learning
discover::discover
differs::differs
statistics::statistics
deals::deals
volumes::volumes
primarily::primarily
discovered::discovered
rule::rule
stated::stated
informally::informally
young::young
womenwith::womenwith
incomes::incomes
buy::buy
sports::sports
cars::cars
universally::universally
true::true
degrees::degrees
confidence::confidence
equations::equations
relating::relating
predicting::predicting
outcomes::outcomes
automatically::automatically
derived::derived
manual::manual
preprocessing::preprocessing
acceptable::acceptable
postprocessing::postprocessing
pattern::pattern
pick::pick
reason::reason
semiautomatic::semiautomatic
concentrate::concentrate
automatic::automatic
aspect::aspect
businesses::businesses
begun::begun
burgeoning::burgeoning
make::make
stock::stock
target::target
extracted::extracted
precompute::precompute
summaries::summaries
amounts::amounts
responses::responses
constructs::constructs
diverse::diverse
sources::sources
making::making
built::built
warehouses::warehouses
gather::gather
uniform::uniform
textual::textual
grown::grown
explosively::explosively
unstructured::unstructured
unlike::unlike
rigidly::rigidly
secondary::secondary
emphasis::emphasis
concentrating::concentrating
keywords::keywords
relevance::relevance
documents::documents
classification::classification
analytical::analytical
warehousing::warehousing
specialty::specialty
areas::areas
limited::limited
restrictions::restrictions
researchers::researchers
datamodels::datamodels
domains::domains
1.11.1::1.11.1
inheritance::inheritance
key::key
found::found
supports::supports
1980s::1980s
presently::presently
extends::extends
traditional::traditional
orientation::orientation
1.11.2::1.11.2
permit::permit
exchange::exchange
nested::nested
flexibility::flexibility
nontraditional::nontraditional
expressing::expressing
transforming::transforming
categorized::categorized
1.12.1::1.12.1
differentiated::differentiated
expect::expect
unsophisticated::unsophisticated
invoking::invoking
hire::hire
fill::fill
wishes::wishes
connects::connects
enters::enters
desired::desired
determines::determines
roster::roster
professionalswho::professionalswho
choose::choose
frommany::frommany
develop::develop
rapid::rapid
rad::rad
reportswith::reportswith
effort::effort
requests::requests
submit::submit
explore::explore
specialized::specialized
fit::fit
computer-aided::computer-aided
knowledgebase::knowledgebase
expert::expert
graphics::graphics
audio::audio
environment-modeling::environment-modeling
1.12.2::1.12.2
administrator::administrator
reasons::reasons
tohave::tohave
thedata::thedata
dba::dba
access-method::access-method
physical-organization::physical-organization
thedbacarries::thedbacarries
reflect::reflect
changing::changing
alter::alter
improve::improve
granting::granting
regulate::regulate
routine::routine
periodically::periodically
backing::backing
tapes::tapes
servers::servers
loss::loss
disasters::disasters
flooding::flooding
free::free
upgrading::upgrading
monitoring::monitoring
jobs::jobs
degraded::degraded
expensive::expensive
tasks::tasks
drives::drives
growth::growth
earliest::earliest
fact::fact
automation::automation
predates::predates
punched::punched
invented::invented
herman::herman
hollerith::hollerith
beginning::beginning
census::census
mechanical::mechanical
systemswere::systemswere
tabulate::tabulate
entering::entering
evolved::evolved
years::years
1950s::1950s
magnetic::magnetic
consisted::consisted
tape::tape
decks::decks
printers::printers
raises::raises
processed::processed
deck::deck
synchronization::synchronization
themaster::themaster
sorted::sorted
master::master
sequentially::sequentially
sizeswere::sizeswere
forced::forced
merging::merging
fromtapes::fromtapes
1970s::1970s
widespread::widespread
scenario::scenario
immaterial::immaterial
location::location
tens::tens
milliseconds::milliseconds
freed::freed
tyranny::tyranny
sequentiality.with::sequentiality.with
trees::trees
landmark::landmark
paper::paper
codd::codd
databaseswere::databaseswere
born::born
simplicity::simplicity
completely::completely
enticing::enticing
won::won
prestigious::prestigious
computing::computing
machinery::machinery
award::award
academically::academically
interesting::interesting
perceived::perceived
notmatch::notmatch
groundbreaking::groundbreaking
project::project
research::research
construction::construction
excellent::excellent
overviews::overviews
astrahan::astrahan
chamberlin::chamberlin
prototype::prototype
sql::NNP
ingres::ingres
california::california
berkeley::berkeley
db2::db2
dec::dec
rdb::rdb
played::played
advancing::advancing
competitivewith::competitivewith
easy::easy
eventually::eventually
replaced::replaced
importantly::importantly
mind::mind
involved::involved
lot::lot
carried::carried
leaving::leaving
attaining::attaining
dominance::dominance
reigned::reigned
supreme::supreme
query-intensive::query-intensive
mainstay::mainstay
transaction-processing::transaction-processing
update-intensive::update-intensive
re-emerged::re-emerged
growths::growths
usage::usage
products::products
began::began
