continue on discussion::continue on discussion
discussion on avl::discussion on avl
insertion and deletion::insertion and deletion
started this discussion::started this discussion
discussion on insertion::discussion on insertion
insert a node::insert a node
insert a key::insert a key
whats a process::whats a process
process of insertion::process of insertion
binary search tree::binary search tree
first you find::first you find
place you put::place you put
put the key::put the key
started the discussion::started the discussion
insertion it doesn::insertion it doesn
remain an avl::remain an avl
height balance property::height balance property
property is violated::property is violated
nodes whose height::nodes whose height
height could change::height could change
call the define::call the define
define the height::define the height
nodes whose heights::nodes whose heights
heights could change::heights could change
subtree has changed::subtree has changed
changed as result::changed as result
node its subtree::node its subtree
node their height::node their height
height might change::height might change
change and change::change and change
height might increase::height might increase
imbalance or unbalanced::imbalance or unbalanced
height balance problem::height balance problem
balance problem height::balance problem height
problem height problem::problem height problem
height problem means::height problem means
height imbalanced height::height imbalanced height
imbalanced height imbalance::imbalanced height imbalance
height imbalance means::height imbalance means
means one left::means one left
subtree the difference::subtree the difference
difference in heights::difference in heights
node v travel::node v travel
tree which means::tree which means
pin the parent::pin the parent
identify the node::identify the node
find the first::find the first
grandparent is unbalanced::grandparent is unbalanced
find the node::find the node
grandchild which grandchild::grandchild which grandchild
grandchild the grandchild::grandchild the grandchild
tree so fifty::tree so fifty
larger smaller larger::larger smaller larger
smaller larger smaller::smaller larger smaller
nodes so note::nodes so note
heights are changed::heights are changed
earlier this node::earlier this node
node had height::node had height
two this node::two this node
path whose height::path whose height
fifty no difference::fifty no difference
difference of height::difference of height
node is changed::node is changed
changed the height::changed the height
path would change::path would change
imbalance happens lets::imbalance happens lets
grandchild means parent::grandchild means parent
parent sorry childs::parent sorry childs
child so child::child so child
rebalance this tree::rebalance this tree
rebalance this subtree::rebalance this subtree
subtree subtree rooted::subtree subtree rooted
performing the rotation::performing the rotation
today is understand::today is understand
subtree this subtree::subtree this subtree
forty eight fifty::forty eight fifty
fifty four sixty::fifty four sixty
sixty two seventy::sixty two seventy
seventy eight eighty::seventy eight eighty
nodes but organized::nodes but organized
node height imbalanced::node height imbalanced
understand this process::understand this process
lets first understand::lets first understand
locally re organizing::locally re organizing
organizing the binary::organizing the binary
tree no node::tree no node
tree i don::tree i don
property of binary::property of binary
lets just forget::lets just forget
forget these links::forget these links
links okay lets::links okay lets
put the links::put the links
happened what happened::happened what happened
search tree properties::search tree properties
properties still holds::properties still holds
done some local::done some local
suppose the insertion::suppose the insertion
drawn the links::drawn the links
out these links::out these links
avoid the clutter::avoid the clutter
root the root::root the root
four different cases::four different cases
denote the height::denote the height
thing the height::thing the height
increasing in height::increasing in height
increase in height::increase in height
height of node::height of node
increased and height::increased and height
increased because height::increased because height
right and height::right and height
balanced after insertion::balanced after insertion
two the fact::two the fact
two right lets::two right lets
right lets continue::right lets continue
continue this argument::continue this argument
repeating the argument::repeating the argument
imbalanced because original::imbalanced because original
two so height::two so height
right so height::right so height
rotation and stuff::rotation and stuff
reduce its size::reduce its size
thing we argued::thing we argued
rotation do rotation::rotation do rotation
recalls will remain::recalls will remain
piece will remain::piece will remain
shown the link::shown the link
heights the height::heights the height
properties are maintained::properties are maintained
argue that height::argue that height
height balanced properties::height balanced properties
height imbalanced happening::height imbalanced happening
balanced no difference::balanced no difference
done a rotation::done a rotation
number of operations::number of operations
four different reference::four different reference
constant number independent::constant number independent
number of nodes::number of nodes
thing is happened::thing is happened
happened the original::happened the original
rotation the height::rotation the height
rotation the remains::rotation the remains
inserted and dead::inserted and dead
dead the rotation::dead the rotation
done i don::done i don
repeat the argument::repeat the argument
symmetric lets assume::symmetric lets assume
means the height::means the height
two now lets::two now lets
originally not balanced::originally not balanced
height has increased::height has increased
imbalanced the height::imbalanced the height
make any difference::make any difference
rotation we ended::rotation we ended
ended up making::ended up making
root the middle::root the middle
key we ended::key we ended
making the root::making the root
two step rotation::two step rotation
rotation so first::rotation so first
remains the left::remains the left
remains the right::remains the right
switch is loyalties::switch is loyalties
right of subtree::right of subtree
two has height::two has height
four has height::four has height
height balanced height::height balanced height
done the job::done the job
remain the right::remain the right
two as left::two as left
lets compute heights::lets compute heights
right so final::right so final
happening you understand::happening you understand
right we ended::right we ended
ended up doing::ended up doing
middle key ended::middle key ended
split the thing::split the thing
height here imbalance::height here imbalance
height imbalance happening::height imbalance happening
kind of split::kind of split
uniformly the heights::uniformly the heights
rotation take constant::rotation take constant
four different ways::four different ways
ways to rotate::ways to rotate
recap you understand::recap you understand
doing this thing::doing this thing
balanced picture height::balanced picture height
picture height balanced::picture height balanced
height balanced picture::height balanced picture
sort the double::sort the double
case after rotation::case after rotation
picture you don::picture you don
single and double::single and double
rotations are done::rotations are done
tree the difference::tree the difference
node the difference::node the difference
delete a node::delete a node
deleting the node::deleting the node
deleting a node::deleting a node
node i copied::node i copied
copied the content::copied the content
node and deleted::node and deleted
deleted the successor::deleted the successor
node i deleted::node i deleted
end up deleting::end up deleting
ended up deleting::ended up deleting
means this node::means this node
tree and node::tree and node
deleting a leaf::deleting a leaf
deleting a parent::deleting a parent
deleting the leaf::deleting the leaf
leaf and copying::leaf and copying
copying the content::copying the content
leaf or parent::leaf or parent
first unbalanced node::first unbalanced node
happen the ancestors::happen the ancestors
height could reduce::height could reduce
unbalanced so lets::unbalanced so lets
unbalanced node encountered::unbalanced node encountered
perform it rotation::perform it rotation
rotation to restore::rotation to restore
restore the balance::restore the balance
case of insertion::case of insertion
rotation you don::rotation you don
stop after doing::stop after doing
doing the rotation::doing the rotation
unbalanced and repeat::unbalanced and repeat
repeat the rotation::repeat the rotation
reach the root::reach the root
device the child::device the child
higher larger height::higher larger height
four i started::four i started
tree i found::tree i found
right so whats::right so whats
whats a problem::whats a problem
node i identified::node i identified
identified which hadn::identified which hadn
imbalanced that happened::imbalanced that happened
happened here earlier::happened here earlier
decreased the height::decreased the height
four has reduced::four has reduced
minus one lets::minus one lets
minus three kind::minus three kind
balanced okay good::balanced okay good
minus one right::minus one right
two h minus::two h minus
last two slides::last two slides
kind of rotation::kind of rotation
heights h minus::heights h minus
continue the argument::continue the argument
height is reduced::height is reduced
bigger thing height::bigger thing height
height as reduced::height as reduced
height of subtree::height of subtree
height and height::height and height
two because height::two because height
minus one good::minus one good
pick the root::pick the root
rotation of mine::rotation of mine
mine the previous::mine the previous
question here asked::question here asked
single rotation case::single rotation case
pick the left::pick the left
pick the right::pick the right
picked it pick::picked it pick
minus one height::minus one height
nodes and tress::nodes and tress
double rotation step::double rotation step
step so first::step so first
child sub tress::child sub tress
happen x moves::happen x moves
height h minus::height h minus
make that argument::make that argument
done single rotation::done single rotation
make this kind::make this kind
kind of argument::kind of argument
happened is final::happened is final
tree has height::tree has height
right you understand::right you understand
height has reduced::height has reduced
require a proof::require a proof
right so thing::right so thing
satisfied by checking::satisfied by checking
checking the parent::checking the parent
insert and delete::insert and delete
insertion we spent::insertion we spent
insert why log::insert why log
log n height::log n height
proportional to height::proportional to height
height we argued::height we argued
doing a rotation::doing a rotation
log n deletion::log n deletion
deletion um recall::deletion um recall
recall that insertion::recall that insertion
insert the node::insert the node
tree to find::tree to find
find the place::find the place
occurs the first::occurs the first
satisfy the height::satisfy the height
insertion basically requires::insertion basically requires
basically requires order::basically requires order
requires order log::requires order log
spend order log::spend order log
takes a log::takes a log
log n order::log n order
order time deletion::order time deletion
hand also requires::hand also requires
requires only order::requires only order
bit more work::bit more work
right the reason::right the reason
delete the node::delete the node
node to recall::node to recall
cases the node::cases the node
node is deleting::node is deleting
deleting is leaf::deleting is leaf
find the success::find the success
find the successor::find the successor
successor swap contents::successor swap contents
delete the successor::delete the successor
occurs having found::occurs having found
rotation that rotation::rotation that rotation
solve your problem::solve your problem
solve the problem::solve the problem
problem of height::problem of height
restore height balance::restore height balance
number of rotations::number of rotations
moving one level::moving one level
log n rotations::log n rotations
rotations only taking::rotations only taking
taking a constant::taking a constant
total time require::total time require
total time required::total time required
entire delete operation::entire delete operation
deletion in avl::deletion in avl
operations of insert::operations of insert
search and delete::search and delete
done in log::done in log
avl trees::avl trees
deletion procedure::deletion procedure
last class::last class
avl tree::avl tree
key right::key right
binary search::binary search
search tree::search tree
height balance::height balance
balance property::balance property
large tree::large tree
insertion process::insertion process
balance problem::balance problem
problem height::problem height
height problem::height problem
problem means::problem means
imbalanced height::imbalanced height
height imbalance::height imbalance
imbalance means::imbalance means
left subtree::left subtree
essentially travel::essentially travel
parent pointer::parent pointer
first node::first node
larger smaller::larger smaller
smaller larger::smaller larger
imbalanced fifty::imbalanced fifty
right difference::right difference
lets call::lets call
first place::first place
grandchild means::grandchild means
means parent::means parent
childs child::childs child
subtree subtree::subtree subtree
subtree rooted::subtree rooted
nodes forty::nodes forty
fifty fifty::fifty fifty
node height::node height
height imbalanced::height imbalanced
process today::process today
first understand::first understand
system rotation::system rotation
huge tree::huge tree
right subtree::right subtree
right child::right child
left child::left child
null tree::null tree
rotation step::rotation step
slow motion::slow motion
tree properties::tree properties
local reorganization::local reorganization
remember lets::remember lets
insertion happened::insertion happened
increasing height::increasing height
imbalanced right::imbalanced right
means height::means height
height remains::height remains
increased implies::increased implies
implies height::implies height
original height::original height
right lets::right lets
lets continue::lets continue
balanced height::balanced height
final thing::final thing
first thing::first thing
big piece::big piece
entire thing::entire thing
height balanced::height balanced
balanced properties::balanced properties
single rotation::single rotation
constant number::constant number
number independent::number independent
interesting thing::interesting thing
subtree remains::subtree remains
symmetric case::symmetric case
symmetric lets::symmetric lets
lets assume::lets assume
height moves::height moves
middle key::middle key
smallest right::smallest right
previous rotation::previous rotation
middle child::middle child
step rotation::step rotation
double rotation::double rotation
compute heights::compute heights
original subtree::original subtree
final tree::final tree
original tree::original tree
key ended::key ended
imbalance happening::imbalance happening
heights reduced::heights reduced
quick recap::quick recap
rotate node::rotate node
balanced picture::balanced picture
picture height::picture height
double rotations::double rotations
binary tree::binary tree
actual node::actual node
successor node::successor node
leaf node::leaf node
lets lets::lets lets
unbalanced node::unbalanced node
link counter::link counter
reduce right::reduce right
node encountered::node encountered
larger height::larger height
ancestor nodes::ancestor nodes
unbalanced repeat::unbalanced repeat
lets understand::lets understand
valid question::valid question
imbalanced node::imbalanced node
higher larger::higher larger
imbalanced imbalance::imbalanced imbalance
guy decreased::guy decreased
wrong statement::wrong statement
bigger tree::bigger tree
bigger thing::bigger thing
thing height::thing height
higher level::higher level
rotation height::rotation height
first part::first part
previous case::previous case
rotation case::rotation case
case height::case height
child sub::child sub
sub tress::sub tress
nodes height::nodes height
ancestors ancestors::ancestors ancestors
correct right::correct right
good question::good question
spent log::spent log
imbalance occurs::imbalance occurs
requires order::requires order
order log::order log
spend order::spend order
left find::left find
successor swap::successor swap
swap contents::swap contents
delete delete::delete delete
restore height::restore height
performer rotation::performer rotation
rotations put::rotations put
entire delete::entire delete
delete operation::delete operation
end today::end today
insert search::insert search
today::today
continue::continue
discussion::discussion
avl::avl
trees::trees
insertion::insertion
deletion::deletion
procedure::procedure
begin::begin
started::started
last::last
class::class
suppose::suppose
insert::insert
node::node
tree::tree
right::right
key::key
whats::whats
process::process
binary::binary
search::search
first::first
find::find
place::place
put::put
consequence::consequence
doesn::doesn
remain::remain
height::height
balance::balance
property::property
violated::violated
nodes::nodes
change::change
result::result
call::call
define::define
subtree::subtree
rooted::rooted
large::large
heights::heights
ancestors::ancestors
return::return
understand::understand
changed::changed
remains::remains
flow::flow
ancestor::ancestor
increased::increased
add::add
increase::increase
imbalance::imbalance
unbalanced::unbalanced
culprit::culprit
problem::problem
means::means
imbalanced::imbalanced
left::left
difference::difference
essentially::essentially
travel::travel
pin::pin
parent::parent
pointer::pointer
identify::identify
grandparent::grandparent
unbalance::unbalance
grandchild::grandchild
travels::travels
path::path
grandchildren::grandchildren
show::show
clearer::clearer
child::child
situation::situation
fifty::fifty
four::four
larger::larger
smaller::smaller
balanced::balanced
note::note
earlier::earlier
two::two
noise::noise
student::student
lets::lets
childs::childs
rebalance::rebalance
performing::performing
rotation::rotation
happen::happen
picture::picture
forty::forty
sixty::sixty
seventy::seventy
eighty::eighty
organized::organized
manner::manner
previous::previous
system::system
locally::locally
organizing::organizing
part::part
huge::huge
subtrees::subtrees
null::null
don::don
care::care
keys::keys
step::step
forget::forget
links::links
replay::replay
slow::slow
motion::motion
sufficiently::sufficiently
back::back
happened::happened
properties::properties
holds::holds
done::done
local::local
reorganization::reorganization
remember::remember
moves::moves
rotations::rotations
drawn::drawn
clear::clear
children::children
slides::slides
pictures::pictures
out::out
avoid::avoid
clutter::clutter
completely::completely
relationships::relationships
counted::counted
leaf::leaf
root::root
questions::questions
point::point
cases::cases
times::times
case::case
denote::denote
thing::thing
originally::originally
tol::tol
adding::adding
increasing::increasing
hindi::hindi
fact::fact
implies::implies
original::original
argument::argument
argued::argued
repeating::repeating
roughly::roughly
guys::guys
guy::guy
initially::initially
question::question
face::face
television::television
stuff::stuff
reduce::reduce
size::size
good::good
quickly::quickly
final::final
things::things
values::values
pair::pair
rotate::rotate
move::move
pardon::pardon
write::write
recalls::recalls
big::big
piece::piece
entire::entire
shown::shown
link::link
written::written
maintained::maintained
argue::argue
restored::restored
happening::happening
single::single
operation::operation
constant::constant
number::number
operations::operations
reference::reference
independent::independent
graph::graph
interesting::interesting
inserted::inserted
dead::dead
important::important
marching::marching
moving::moving
symmetric::symmetric
handle::handle
trust::trust
leave::leave
repeat::repeat
assuming::assuming
assume::assume
make::make
bit::bit
middle::middle
largest::largest
smallest::smallest
recall::recall
line::line
top::top
ended::ended
making::making
similar::similar
double::double
moved::moved
switch::switch
loyalties::loyalties
copied::copied
job::job
compute::compute
doing::doing
split::split
uniformly::uniformly
coming::coming
kind::kind
reduced::reduced
quick::quick
recap::recap
ways::ways
sort::sort
understood::understood
principle::principle
delete::delete
deleting::deleting
successor::successor
content::content
deleted::deleted
actual::actual
end::end
copying::copying
mind::mind
slightly::slightly
differently::differently
counter::counter
encountered::encountered
traveling::traveling
defining::defining
lef::lef
perform::perform
restore::restore
worry::worry
stop::stop
reason::reason
reach::reach
device::device
minute::minute
valid::valid
ignore::ignore
minus::minus
higher::higher
found::found
decreased::decreased
choosing::choosing
follow::follow
draw::draw
walking::walking
identified::identified
hadn::hadn
simple::simple
relationship::relationship
straight::straight
wrong::wrong
statement::statement
bigger::bigger
wave::wave
level::level
pick::pick
mine::mine
asked::asked
give::give
picked::picked
copy::copy
tress::tress
sub::sub
strictly::strictly
require::require
continuing::continuing
proof::proof
correct::correct
youe::youe
satisfied::satisfied
checking::checking
answer::answer
running::running
spent::spent
log::log
finding::finding
proportional::proportional
start::start
occurs::occurs
satisfy::satisfy
basically::basically
requires::requires
order::order
spend::spend
takes::takes
hand::hand
work::work
success::success
swap::swap
contents::contents
solve::solve
performer::performer
taking::taking
total::total
required::required
eventually::eventually
