::
all::all
code::code
forget::forget
four::four
go::go
follow::following
children::children
whose::whose
decid::decide
middl::middle
depend::depends
sorri::sorry
to::to
me::me
everi::every
worst::worst
veri::very
tri::try
level::levels
did::did
list::list
geograph::geographic
iter::iterative
guy::guy
pleas::please
the::the
smaller::smaller
ten::ten
zero::zero
will::will
what::what
sub::sub
compar::compare
abl::able
current::current
delet::deletion
version::version
new::new
ever::ever
hash::hashing
here::here
satisfi::satisfy
let::lets
becom::becomes
modifi::modified
sinc::since
valu::value
search::search
shift::shift
k::k
larger::larger
amount::amount
thirti::thirty
permit::permitting
implement::implementing
put::put
total::total
use::use
from::from
would::would
two::two
next::next
eleven::eleven
call::call
tell::tell
today::today
more::more
comparison::comparison
relat::relation
particular::particular
hold::holds
logarithm::logarithmic
uniqu::unique
can::can
v::v
my::my
give::give
process::process
minimum::minimum
want::want
cours::course
end::end
anoth::another
six::six
write::write
how::how
simpl::simple
okay::okay
may::may
max::max
after::after
befor::before
wrong::wrong
such::such
data::data
a::a
essenti::essentially
element::element
si::si
preced::precedes
so::so
order::order
talk::talk
becaus::because
through::through
still::still
pointer::pointer
paramet::parameter
till::till
might::might
then::then
them::them
good::good
recal::recall
halv::halve
handl::handle
ye::yes
they::they
recap::recap
now::now
discuss::discussion
successor::successor
somewher::somewhere
name::names
easili::easily
each::each
found::found
went::went
mean::means
yeah::yeah
procedur::procedure
thirteen::thirteen
our::our
happen::happens
out::out
shown::shown
goe::goes
correct::correction
situat::situations
given::given
ineffici::inefficient
fourteen::fourteen
dictionari::dictionary
ask::asked
could::could
keep::keep
thing::thing
perhap::perhaps
place::place
think::think
first::first
oper::operation
onc::once
number::number
one::one
done::done
array::array
size::size
differ::differently
t::t
their::their
necessarili::necessarily
similarli::similarly
twenti::twenty
store::stored
lot::lot
that::that
part::part
exactli::exactly
than::than
kind::kind
tree::tree
structur::structure
matter::matters
were::were
posit::position
and::and
comput::compute
ani::any
say::saying
manner::manner
have::have
need::need
seen::seen
null::null
lie::lies
min::min
note::note
also::also
take::take
which::which
noth::nothing
begin::begin
reach::reach
whi::why
most::most
eight::eight
pair::pairs
class::class
clear::clear
adopt::adopt
doe::does
away::away
dot::dot
show::showed
trivial::trivialities
find::finding
onli::only
locat::location
nois::noise
should::should
suppos::suppose
predecessor::predecessor
do::do
get::getting
organ::organize
h::h
twelv::twelve
contain::contain
x::x
where::where
set::setting
we::we
maximum::maximum
see::see
are::are
said::said
someth::something
written::written
smallest::smallest
simplest::simplest
accord::according
wa::was
entir::entire
key::key
come::come
both::both
ill::ill
equal::equal
s::s
improv::improve
point::pointing
height::height
assum::assume
duplic::duplicate
quit::quite
coupl::couple
three::three
empti::empty
much::much
besid::besides
hindi::hindi
interest::interested
basic::basically
understand::understand
child::child
case::case
look::look
these::these
properti::property
n::n
n't::n't
defin::define
while::while
everyon::everyone
loop::loop
seven::seven
is::is
henc::hence
it::its
eighteen::eighteen
in::in
return::return
id::id
trival::trivals
if::if
alphabet::alphabetic
make::make
same::same
binari::binary
largest::largest
inch::inch
eventu::eventually
nil::nil
upon::upon
hand::hand
fairli::fairly
student::student
mani::many
i::i
well::well
exampl::example
thi::this
everyth::everything
left::left
just::just
less::less
rest::rest
not::not
wee::wee
had::had
except::excepting
match::matching
gave::gave
five::five
know::know
recurs::recursive
insert::insertion
like::like
integ::integers
unord::unordered
either::either
right::right
often::often
some::some
root::root
leaf::leaf
for::for
larg::large
complic::complicate
refer::referring
be::be
plu::plus
run::running
step::step
throw::throw
on::on
about::about
actual::actually
of::of
or::or
down::down
your::your
log::log
execut::executed
there::there
question::question
start::started
way::way
function::function
but::but
continu::continue
ha::has
with::with
whether::whether
up::up
um::um
otherwis::otherwise
problem::problem
featur::features
constant::constant
certain::certain
am::am
an::an
as::as
at::at
again::again
no::no
when::when
field::field
other::other
rememb::remember
you::you
node::node
's::'s
pseudo::pseudo
notion::notion
came::came
time::time
