sujoy ghosh lecture::sujoy ghosh lecture
discuss the network::discuss the network
basically a computer::basically a computer
number of nodes::number of nodes
call a graph::call a graph
representing the network::representing the network
network this graph::network this graph
structure we talk::structure we talk
structure this structure::structure this structure
general not feasible::general not feasible
pair of node::pair of node
matter of discussion::matter of discussion
nodes may represent::nodes may represent
computer or network::computer or network
devices like switches::devices like switches
links represent communication::links represent communication
represent communication links::represent communication links
communication links modes::communication links modes
modes of communication::modes of communication
broadcast or point::broadcast or point
point to point::point to point
lan topologies lan::lan topologies lan
local area network::local area network
network and local::network and local
area network topologies::area network topologies
ring and bus::ring and bus
kind of network::kind of network
shared broadcast link::shared broadcast link
pair of communicating::pair of communicating
send his message::send his message
ignore the communication::ignore the communication
links are shared::links are shared
ignore this communication::ignore this communication
protocol to decide::protocol to decide
communications will collide::communications will collide
shared broadcast medium::shared broadcast medium
medium the communication::medium the communication
pairs of node::pairs of node
cable a single::cable a single
single cable connects::single cable connects
computers are hanging::computers are hanging
cable each computer::cable each computer
computer is connected::computer is connected
cable so computers::cable so computers
computers must synchronize::computers must synchronize
computer to transmit::computer to transmit
single copper cable::single copper cable
cable and computers::cable and computers
network is maintained::network is maintained
single cable cable::single cable cable
cable cable segment::cable cable segment
segment must end::segment must end
sends a signal::sends a signal
kind of unwanted::kind of unwanted
types of coaxial::types of coaxial
thin coaxial cable::thin coaxial cable
cable called thin::cable called thin
thick coaxial cable::thick coaxial cable
cable called thick::cable called thick
lan and extra::lan and extra
daisy chain manner::daisy chain manner
manner this technology::manner this technology
technology is sort::technology is sort
thin and thick::thin and thick
people are moving::people are moving
problem in communication::problem in communication
obsolete these days::obsolete these days
single broadcast medium::single broadcast medium
machines are sharing::machines are sharing
topology is ieee::topology is ieee
eliminate that cable::eliminate that cable
cable and replace::cable and replace
range of segment::range of segment
meters the maximum::meters the maximum
number of connections::number of connections
devices four repeaters::devices four repeaters
total cable length::total cable length
signal gets weak::signal gets weak
regenerate the signal::regenerate the signal
incoming weak signal::incoming weak signal
send the stronger::send the stronger
line the maximum::line the maximum
nodes per segment::nodes per segment
advantages and disadvantages::advantages and disadvantages
easy to add::easy to add
cable and add::cable and add
add new station::add new station
station that means::station that means
computer the amount::computer the amount
amount of cable::amount of cable
recommended which means::recommended which means
parts any longer::parts any longer
out of fashion::out of fashion
number of devices::number of devices
difficult to isolate::difficult to isolate
isolate the problems::isolate the problems
slows the response::slows the response
direct point-to-point communication::direct point-to-point communication
communication that means::communication that means
dedicated point-to-point communication::dedicated point-to-point communication
communication so computers::communication so computers
computers are connected::computers are connected
connected by communication::connected by communication
network that means::network that means
pairs of nodes::pairs of nodes
flexibility in communication::flexibility in communication
security and privacy::security and privacy
privacy because communication::privacy because communication
number of cables::number of cables
cables you require::cables you require
means the number::means the number
length of cables::length of cables
kind of cable::kind of cable
previous thin lan::previous thin lan
kind of structure::kind of structure
area network suppose::area network suppose
means every node::means every node
node and length::node and length
nodes this means::nodes this means
easy to provide::easy to provide
kind of mesh::kind of mesh
alternative another reason::alternative another reason
two different buildings::two different buildings
lot of cables::lot of cables
reduce the number::reduce the number
number of communication::number of communication
idea of communicating::idea of communicating
lan it means::lan it means
necessarily we share::necessarily we share
share the connections::share the connections
ways of doing::ways of doing
computer takes turns::computer takes turns
include some technique::include some technique
technique for synchronizing::technique for synchronizing
common these days::common these days
topology a star::topology a star
nodes are connected::nodes are connected
star its physical::star its physical
hub is made::hub is made
advantage of converting::advantage of converting
previously a bus::previously a bus
cable the cable::cable the cable
handle the connections::handle the connections
long running cable::long running cable
difficult to locate::difficult to locate
locate loose connections::locate loose connections
find out failures::find out failures
physical star topology::physical star topology
topology still maintains::topology still maintains
maintains a logical::maintains a logical
logical bus topology::logical bus topology
case these days::case these days
previous star diagram::previous star diagram
diagram is idealized::diagram is idealized
kind of connection::kind of connection
ubiquitous these cables::ubiquitous these cables
kind of cables::kind of cables
cables which connect::cables which connect
connect your telephones::connect your telephones
cables or unshielded::cables or unshielded
unshielded twisted pair::unshielded twisted pair
twisted pair cables::twisted pair cables
easier to handle::easier to handle
cheaper these connections::cheaper these connections
lan or thick::lan or thick
extended star topology::extended star topology
means different stars::means different stars
manner that means::manner that means
means the hubs::means the hubs
stars are connected::stars are connected
switches these switches::switches these switches
switches are connected::switches are connected
topology some part::topology some part
medium some part::medium some part
coaxial cable running::coaxial cable running
leaving a thin::leaving a thin
topology in ring::topology in ring
lot of advantage::lot of advantage
first node passes::first node passes
passes the data::passes the data
reaches the destination::reaches the destination
reach the destination::reach the destination
destination will copy::destination will copy
short connected cable::short connected cable
ring ring connections::ring ring connections
connections may run::connections may run
run past offices::run past offices
offices with connector::offices with connector
cables to sockets::cables to sockets
ring the data::ring the data
put two rings::put two rings
reason for putting::reason for putting
putting two rings::putting two rings
nodes can sense::nodes can sense
sort of wrap::sort of wrap
wrap the ring::wrap the ring
nodes these nodes::nodes these nodes
node may break::node may break
link may fail::link may fail
things may happen::things may happen
wide area network::wide area network
lot of things::lot of things
exchanges are connected::exchanges are connected
fashion using fiber::fashion using fiber
fiber optics cable::fiber optics cable
cable is cut::cable is cut
beginning or end::beginning or end
ring all devices::ring all devices
devices have equal::devices have equal
access to media::access to media
media one good::media one good
ring allows fault::ring allows fault
tolerance each device::tolerance each device
wait its turn::wait its turn
turn to transmit::turn to transmit
transmit that means::transmit that means
token ring token::token ring token
ring token ring::ring token ring
ieee standard number::ieee standard number
data it reaches::data it reaches
data is extracted::data is extracted
acknowledgement of receipt::acknowledgement of receipt
back to transmitting::back to transmitting
empty token passed::empty token passed
make a data::make a data
kind of identification::kind of identification
bunch of data::bunch of data
data the destination::data the destination
extract the data::extract the data
acknowledgement and send::acknowledgement and send
remove this acknowledgement::remove this acknowledgement
token is passed::token is passed
send and send::send and send
disadvantages the advantages::disadvantages the advantages
data packets travel::data packets travel
travel at great::travel at great
reason why data::reason why data
packets can travel::packets can travel
synchronizing their actions::synchronizing their actions
two different nodes::two different nodes
nodes may start::nodes may start
data will collide::data will collide
ways of synchronization::ways of synchronization
easier to find::easier to find
faults and rectify::faults and rectify
faults and terminators::faults and terminators
cable the disadvantages::cable the disadvantages
requires more cable::requires more cable
couple of breakdowns::couple of breakdowns
breakdowns may bring::breakdowns may bring
bring the entire::bring the entire
ring down smaller::ring down smaller
smaller rings exist::smaller rings exist
rings exist nowadays::rings exist nowadays
network is concerned::network is concerned
network a ring::network a ring
matter of fact::matter of fact
fact the ring::fact the ring
topology that wide::topology that wide
topology use token::topology use token
passing for synchronized::passing for synchronized
ring the ring::ring the ring
single shared communication::single shared communication
shared communication medium::shared communication medium
communication medium bits::communication medium bits
medium bits pass::medium bits pass
pass from transmitter::pass from transmitter
past other computers::past other computers
copied by destination::copied by destination
designed to pass::designed to pass
out of commission::out of commission
ring can function::ring can function
computer is shut::computer is shut
sender holding token::sender holding token
holding token transmits::holding token transmits
token transmits bits::token transmits bits
bits of frames::bits of frames
computer not holding::computer not holding
holding the token::holding the token
passes the bits::passes the bits
speed the destination::speed the destination
makes a copy::makes a copy
receives the bits::receives the bits
network could work::network could work
token after transmission::token after transmission
transmission computer transmits::transmission computer transmits
computer transmits token::computer transmits token
ready to transmit::ready to transmit
transmit it receives::transmit it receives
transmits this token::transmits this token
fell into disuse::fell into disuse
token ring devices::token ring devices
dominant lan technology::dominant lan technology
lived on due::lived on due
tolerance this technology::tolerance this technology
ring is made::ring is made
made of fiber::made of fiber
fiber optic cables::fiber optic cables
optic cables multi::optic cables multi
cables multi mode::cables multi mode
multi mode fibers::multi mode fibers
single mode fibers::single mode fibers
fairly high speed::fairly high speed
level possible nowadays::level possible nowadays
nowadays fddi technology::nowadays fddi technology
speed may sound::speed may sound
sound less today::sound less today
speed the basic::speed the basic
inherent fault tolerance::inherent fault tolerance
fault tolerance capability::fault tolerance capability
fault tolerant ring::fault tolerant ring
tolerant ring technology::tolerant ring technology
technology whose full::technology whose full
form is fiber::form is fiber
fiber distributed data::fiber distributed data
distributed data interconnect::distributed data interconnect
optic between stations::optic between stations
order of magnitude::order of magnitude
pairs of fibers::pairs of fibers
fibers to form::fibers to form
form two concentric::form two concentric
two concentric rings::two concentric rings
rings in order::rings in order
tolerance we require::tolerance we require
stars will form::stars will form
fddi is configured::fddi is configured
configured some fddi::configured some fddi
fddi switches form::fddi switches form
form a ring::form a ring
start other kind::start other kind
kind of technologies::kind of technologies
technologies like ethernet::technologies like ethernet
form a tree-like::form a tree-like
networks are updated::networks are updated
updated and replaced::updated and replaced
leaving some older::leaving some older
replaced one part::replaced one part
part of network::part of network
kind of topology::kind of topology
types of topologies::types of topologies
topologies the common::topologies the common
bus or star::bus or star
star ring star::star ring star
ring star ring::ring star ring
multi-station access unit::multi-station access unit
basically a part::basically a part
part of fddi::part of fddi
study of mesh::study of mesh
meant a complete::meant a complete
graph as shown::graph as shown
lot of cable::lot of cable
lot of alternative::lot of alternative
node the diagram::node the diagram
shows eight nodes::shows eight nodes
path and indirect::path and indirect
destination this means::destination this means
arrangement takes lot::arrangement takes lot
nodes becomes disconnected::nodes becomes disconnected
form of redundancy::form of redundancy
level of fault::level of fault
mesh the network::mesh the network
difficult to evolve::difficult to evolve
evolve a protocol::evolve a protocol
protocol like token::protocol like token
token passing protocol::token passing protocol
method of sensing::method of sensing
sensing the faults::sensing the faults
faults and correcting::faults and correcting
partial mesh topology::partial mesh topology
common on lans::common on lans
wans to interconnect::wans to interconnect
lans because wan::lans because wan
costly the users::costly the users
link naturally expect::link naturally expect
grade of service::grade of service
wan service providers::wan service providers
paths becomes unavailable::paths becomes unavailable
failure or due::failure or due
send the traffic::send the traffic
pros and cons::pros and cons
cons of mesh::cons of mesh
improves fault tolerance::improves fault tolerance
carry more data::carry more data
data the disadvantages::data the disadvantages
increased cost installation::increased cost installation
difficulty in management::difficulty in management
management and troubleshooting::management and troubleshooting
topologies has advantages::topologies has advantages
disadvantages rings ease::disadvantages rings ease
rings ease synchronization::rings ease synchronization
cable breaks star::cable breaks star
star is easier::star is easier
easier to manage::easier to manage
cable bus requires::cable bus requires
bus requires fewer::bus requires fewer
requires fewer cables::requires fewer cables
disabled if cable::disabled if cable
lan is concerned::lan is concerned
people are gravitating::people are gravitating
gravitating towards star::gravitating towards star
topology that means::topology that means
means some nodes::means some nodes
fashion extended star::fashion extended star
emerging in local::emerging in local
local area networks::local area networks
networks in wide::networks in wide
wide area networks::wide area networks
cable ducts running::cable ducts running
cables are passing::cables are passing
connect two cables::connect two cables
pairs of cables::pairs of cables
make a star::make a star
access the medium::access the medium
medium and transmits::medium and transmits
topology a lan::topology a lan
revealing cables emerging::revealing cables emerging
necessarily a star::necessarily a star
piece of network::piece of network
hub this hub::hub this hub
hub actually replaces::hub actually replaces
replaces the single::replaces the single
star connection people::star connection people
people use hubs::people use hubs
hubs these days::hubs these days
cable like thin::cable like thin
lan and thick::lan and thick
kind of box::kind of box
choice of logical::choice of logical
affect the physical::affect the physical
kind of physical::kind of physical
dictate the kind::dictate the kind
kind of logical::kind of logical
actual physical topology::actual physical topology
type of network::type of network
boxes like switches::boxes like switches
difficult to change::difficult to change
change the part::change the part
designing a network::designing a network
put the physical::put the physical
physical topology min::physical topology min
topology min place::topology min place
correct logical topology::correct logical topology
topology your choice::topology your choice
choice will determine::choice will determine
determine cable installation::determine cable installation
cable installation network::cable installation network
connections and protocols::connections and protocols
protocols and spots::protocols and spots
account while deciding::account while deciding
kind of technology::kind of technology
kinds of lan::kinds of lan
topology the kind::topology the kind
kind of situation::kind of situation
question of scalability::question of scalability
choked or people::choked or people
users will join::users will join
happening a network::happening a network
putting some kind::putting some kind
scale the network::scale the network
change the number::change the number
bus by putting::bus by putting
put a switch::put a switch
star topology kind::star topology kind
kind of thing::kind of thing
design your physical::design your physical
ease of installation::ease of installation
ease of finding::ease of finding
central cabling plan::central cabling plan
cables are coming::cables are coming
central place .there::central place .there
.there are standards::.there are standards
standards like structured::standards like structured
easy fault finding::easy fault finding
finding and maintenance::finding and maintenance
lecture good day::lecture good day
day ! today::day ! today
talking about multiplexing::talking about multiplexing
sharing a medium::sharing a medium
medium different users::medium different users
medium for communication::medium for communication
carry one signal::carry one signal
.for multiple signals::.for multiple signals
signals to share::signals to share
share one medium::share one medium
divided to give::divided to give
give each signal::give each signal
signal a portion::signal a portion
portion of total::portion of total
communication is concerned::communication is concerned
facilitate the communication::facilitate the communication
number of pairs::number of pairs
pairs of senders::pairs of senders
senders and receivers.that::senders and receivers.that
idea of multiplexing::idea of multiplexing
leased lines packet::leased lines packet
lines packet switched::lines packet switched
packet switched networks::packet switched networks
laying of line::laying of line
expensive and complex::expensive and complex
lay a line::lay a line
amount of communication::amount of communication
multiplexing and compression::multiplexing and compression
compression techniques save::compression techniques save
save a lot::save a lot
lot of money::lot of money
send a lot::send a lot
lot of data::lot of data
line the data::line the data
company .most data::company .most data
.most data devices::.most data devices
devices individually require::devices individually require
individually require modest::individually require modest
require modest amount::require modest amount
amount of data::amount of data
number of users::number of users
users their aggregated::users their aggregated
requirements may occupy::requirements may occupy
technique to accomplish::technique to accomplish
accomplish this include::accomplish this include
include frequency division::include frequency division
frequency division multiplexing::frequency division multiplexing
wavelength division multiplexing::wavelength division multiplexing
multiplexing and code::multiplexing and code
code division multiplexing::code division multiplexing
scheme of multiplexing::scheme of multiplexing
inputs are coming::inputs are coming
physical link .on::physical link .on
number of sender::number of sender
sender receiver pairs::sender receiver pairs
pairs are utilizing::pairs are utilizing
alternative to multiplexing::alternative to multiplexing
number of problems::number of problems
problems .first problem::problems .first problem
amount of wiring::amount of wiring
multi drop line::multi drop line
host polls machine::host polls machine
lines total communications::lines total communications
total communications load::total communications load
rate of line::rate of line
line out link::line out link
out link carries::out link carries
link carries multiple::link carries multiple
carries multiple channels::carries multiple channels
channels of information::channels of information
quantum of noise::quantum of noise
.if the noise::.if the noise
noise is high::noise is high
lose some information::lose some information
loss of information::loss of information
case of digital::case of digital
compared to analog::compared to analog
errors in transmission::errors in transmission
transmission using digital::transmission using digital
signals we add::signals we add
add few bytes::add few bytes
bytes of error::bytes of error
error checking information::error checking information
error is detected::error is detected
bits called byte::bits called byte
add an extra::add an extra
byte would make::byte would make
make the number::make the number
end we find::end we find
flipped that means::flipped that means
means some bits::means some bits
number of bits::number of bits
bits are supposed::bits are supposed
adding one bit::adding one bit
original that means::original that means
means the sending::means the sending
station was odd::station was odd
.in that case::.in that case
case the receiver::case the receiver
receiver may request::receiver may request
request the sender::request the sender
sender to retransmit::sender to retransmit
kind of error::kind of error
sophisticated error checking::sophisticated error checking
error checking methods::error checking methods
checking methods employed::checking methods employed
employed in networks::employed in networks
networks and communications::networks and communications
networks prof .sujoy::networks prof .sujoy
prof .sujoy ghosh::prof .sujoy ghosh
.sujoy ghosh indian::.sujoy ghosh indian
ghosh indian institute::ghosh indian institute
institute of technology::institute of technology
technology i.i.t kharagpur::technology i.i.t kharagpur
i.i.t kharagpur lecture::i.i.t kharagpur lecture
two protocol stacks::two protocol stacks
osi protocol stack::osi protocol stack
stack in detail::stack in detail
cpi pre reference::cpi pre reference
pre reference stack::pre reference stack
characteristics of physical::characteristics of physical
data can travel::data can travel
two different modes::two different modes
kind of signal::kind of signal
represents a series::represents a series
zeros ? stream::zeros ? stream
stream of bits::stream of bits
media to carry::media to carry
divided into channels::divided into channels
sort of divide::sort of divide
give different channels::give different channels
users ; specific::users ; specific
medium and technology::medium and technology
speed of communication::speed of communication
communication will depend::communication will depend
channel can carry::channel can carry
represent the values::represent the values
carry the digital::carry the digital
harmonics ? harmonics::harmonics ? harmonics
means the sin::means the sin
sin x constant::sin x constant
sin 2x constant::sin 2x constant
pure sin wave::pure sin wave
make a comparison::make a comparison
comparison of analog::comparison of analog
analog verses digital::analog verses digital
verses digital signals::verses digital signals
digital signals digital::digital signals digital
signals digital signals::signals digital signals
prone that means::prone that means
kind of distortion::kind of distortion
source and destination::source and destination
limited extent errors::limited extent errors
talking about analog::talking about analog
control over signal::control over signal
limitations in technology::limitations in technology
signal still rules::signal still rules
statement that digital::statement that digital
affects an analog::affects an analog
hard to deduce::hard to deduce
deduce the original::deduce the original
kind of noise::kind of noise
signal gets distorted::signal gets distorted
signal was sort::signal was sort
sort of square::sort of square
easily in digital::easily in digital
channel is concerned::channel is concerned
number of signal::number of signal
transmit ? suppose::transmit ? suppose
bits in terms::bits in terms
terms of digital::terms of digital
higher the bandwidth::higher the bandwidth
higher the number::higher the number
regenerate slightly damaged::regenerate slightly damaged
slightly damaged signals::slightly damaged signals
weaker in strength::weaker in strength
result of noise::result of noise
fault-tolerant or resistant::fault-tolerant or resistant
resistant to noise::resistant to noise
advantage of digital::advantage of digital
bytes of error-checking::bytes of error-checking
bits called bytes::bits called bytes
bits was supposed::bits was supposed
dictate the number::dictate the number
kind of error-checking::kind of error-checking
sophisticated error-checking methods::sophisticated error-checking methods
error-checking methods employed::error-checking methods employed
networks and communication::networks and communication
error-checking and correction::error-checking and correction
correction of error::correction of error
sophisticated coding technique::sophisticated coding technique
carry sensitive information::carry sensitive information
e-banking is coming::e-banking is coming
coming in vogue::coming in vogue
network similarly e-commerce::network similarly e-commerce
buy something online::buy something online
transaction take place::transaction take place
sending some information::sending some information
credit card number::credit card number
set of numbers::set of numbers
snoops and finds::snoops and finds
out the stream::out the stream
out the original::out the original
application these days::application these days
digital transmission compression::digital transmission compression
compress a message::compress a message
message before transmission::message before transmission
transmission and decompress::transmission and decompress
network is lighter::network is lighter
load is lighter::load is lighter
lossy compression techniques::lossy compression techniques
non-lossy compression techniques::non-lossy compression techniques
compression techniques lossy::compression techniques lossy
techniques lossy compression::techniques lossy compression
lossy compression technique::lossy compression technique
send a digital::send a digital
photograph a digital::photograph a digital
serve the purpose::serve the purpose
purpose sometimes loss::purpose sometimes loss
compression is acceptable::compression is acceptable
taking less amount::taking less amount
amount of space::amount of space
compression and decompression::compression and decompression
kind of overhead::kind of overhead
presence or absence::presence or absence
voltage might represent::voltage might represent
represent a binary::represent a binary
voltage i interpret::voltage i interpret
kind of electrical::kind of electrical
electrical signal traveling::electrical signal traveling
light for communication::light for communication
communication the presence::communication the presence
presence of light::presence of light
absence of light::absence of light
wave to encode::wave to encode
form the current::form the current
signal is digital::signal is digital
forced to send::forced to send
send some digital::send some digital
signal by analog::signal by analog
preferred analog signal::preferred analog signal
signal will transmit::signal will transmit
transmit whatever signal::transmit whatever signal
digital or analog::digital or analog
kind of regeneration::kind of regeneration
trouble with amplifiers::trouble with amplifiers
out the noise::out the noise
noise and regenerate::noise and regenerate
regenerate the original::regenerate the original
signal becomes weak::signal becomes weak
make it stronger::make it stronger
noise is coming::noise is coming
data using analog::data using analog
transmission is concerned::transmission is concerned
recover the pattern::recover the pattern
pattern of zeros::pattern of zeros
carries digital data::carries digital data
analog signal carries::analog signal carries
signal carries digital::signal carries digital
recovers the digital::recovers the digital
generates new clean::generates new clean
clean analog signal::clean analog signal
essentially an analog::essentially an analog
computer is digital::computer is digital
make this digital::make this digital
digital data ride::digital data ride
reaches the telephone::reaches the telephone
back to digital::back to digital
encode digital information::encode digital information
amplitude shift keying::amplitude shift keying
two binary numbers::two binary numbers
two different amplitudes::two different amplitudes
amplitudes of carrier::amplitudes of carrier
kbps on voice::kbps on voice
voice grade lines::voice grade lines
transmit digital data::transmit digital data
data over optical::data over optical
signal is analog::signal is analog
signal is supposed::signal is supposed
amplitude and high::amplitude and high
give this high::give this high
low amplitude analog::low amplitude analog
amplitude analog signal::amplitude analog signal
efficient more common::efficient more common
so-called frequency shift::so-called frequency shift
frequency shift keying::frequency shift keying
keying in frequency::keying in frequency
two different frequencies::two different frequencies
two binary digits::two binary digits
susceptible to error::susceptible to error
error than amplitude::error than amplitude
so-called phase shift::so-called phase shift
phase shift keying::phase shift keying
keying two binary::keying two binary
represented by phase::represented by phase
shift of carrier::shift of carrier
efficient and noise::efficient and noise
resistant than fsk::resistant than fsk
voice grade line::voice grade line
simple phase shift::simple phase shift
complex phase shift::complex phase shift
techniques in order::techniques in order
order to achieve::order to achieve
achieve even higher::achieve even higher
higher data rates::higher data rates
data rates nowadays::data rates nowadays
common to combine::common to combine
combine phase shift::combine phase shift
shift and amplitude::shift and amplitude
line the modems::line the modems
technique called multilevel::technique called multilevel
signaling each signal::signaling each signal
phase or frequency::phase or frequency
bit or bits::bit or bits
kind of technique::kind of technique
bits of information::bits of information
number of times::number of times
times the signal::times the signal
signal will change::signal will change
rate and bit::rate and bit
encoding of analog::encoding of analog
system are nowadays::system are nowadays
nowadays entirely digital::nowadays entirely digital
in-between in order::in-between in order
advantages of robustness::advantages of robustness
voice is analog::voice is analog
core telephone system::core telephone system
system is digital::system is digital
set of codecs::set of codecs
coders and decoders::coders and decoders
convert this analog::convert this analog
analog voice signal::analog voice signal
kind of digital::kind of digital
system is limited::system is limited
khz this telephone::khz this telephone
first so-called gold::first so-called gold
so-called gold quality::so-called gold quality
high fidelity kind::high fidelity kind
kind of sound::kind of sound
limit the bandwidth::limit the bandwidth
noticeable so voice::noticeable so voice
khz of analog::khz of analog
send this analog::send this analog
back nyquist rate::back nyquist rate
sample any analog::sample any analog
signal at double::signal at double
double the maximum::double the maximum
reconstruct the original::reconstruct the original
original analog signal::original analog signal
khz of signal::khz of signal
khz of bandwidth::khz of bandwidth
points my voice::points my voice
point my voice::point my voice
capturing how high::capturing how high
high or low::high or low
low the volume::low the volume
lot we require::lot we require
samples that makes::samples that makes
kbps please remember::kbps please remember
remember this rate::remember this rate
planned their network::planned their network
places in telecommunications::places in telecommunications
data is encoded::data is encoded
encoded the simplest::encoded the simplest
so-called nrz encoding::so-called nrz encoding
two different voltage::two different voltage
levels to represent::levels to represent
typically negative voltage::typically negative voltage
negative voltage equals::negative voltage equals
positive voltage equals::positive voltage equals
signal never returns::signal never returns
voltage the value::voltage the value
value during bit::value during bit
voltage really remains::voltage really remains
boundaries of bit::boundaries of bit
number of transition::number of transition
kind of scheme::kind of scheme
nrzi that means::nrzi that means
means non return::means non return
voltage during bit::voltage during bit
transition from low::transition from low
low to high::low to high
high to low::high to low
voltage and negative::voltage and negative
constant level signal::constant level signal
interpret the signal::interpret the signal
nrz and nrzi::nrz and nrzi
kind of encoding::kind of encoding
disadvantages of nrz::disadvantages of nrz
ends or starts::ends or starts
drift between timing::drift between timing
timing of transmitter::timing of transmitter
transmitter and receiver::transmitter and receiver
results in errors::results in errors
bit phase encoding::bit phase encoding
transition per bit::transition per bit
clocks can remain::clocks can remain
predictable bit transition::predictable bit transition
manchester and differential::manchester and differential
high transition means::high transition means
low transition means::low transition means
clock synchronization purposes::clock synchronization purposes
period is equal::period is equal
transition is bit::transition is bit
token ring networks::token ring networks
popular these days::popular these days
kinds of encoding::kinds of encoding
ways of encoding::ways of encoding
encoding the digital::encoding the digital
levels and bit::levels and bit
area in communications::area in communications
communications in general::communications in general
radio is carrying::radio is carrying
order to reach::order to reach
send your radio::send your radio
bandwidth is sort::bandwidth is sort
sort of translated::sort of translated
high-frequency so-called carrier::high-frequency so-called carrier
so-called carrier wave::so-called carrier wave
signal is carrying::signal is carrying
doing this so-called::doing this so-called
wave is changed::wave is changed
modulation the frequency::modulation the frequency
phase is changed::phase is changed
picture of digital::picture of digital
means zero represents::means zero represents
represents the low::represents the low
voltage and digital::voltage and digital
signaling and state::signaling and state
examples of encoding::examples of encoding
times a signal::times a signal
signal can change::signal can change
rate and baud::rate and baud
case the bit::case the bit
two signal levels::two signal levels
media that means::media that means
throwing some signal::throwing some signal
send some signal::send some signal
piece of wire::piece of wire
fiber optic cable::fiber optic cable
kind of change::kind of change
kinds of effects::kinds of effects
design our systems::design our systems
signal this kind::signal this kind
change and distortion::change and distortion
attenuation a signal::attenuation a signal
signal get weaker::signal get weaker
propagates ; attenuation::propagates ; attenuation
attenuation becomes greater::attenuation becomes greater
greater with distance::greater with distance
weak to recognize::weak to recognize
original signal strength::original signal strength
distance grows signals::distance grows signals
signals become weaker::signals become weaker
weaker and weaker::weaker and weaker
kind of weakening::kind of weakening
weakening is dependent::weakening is dependent
kind of frequency::kind of frequency
short wave signal::short wave signal
signal may travel::signal may travel
make the cable::make the cable
problems for making::problems for making
cable very long::cable very long
signal propagation point::signal propagation point
point of view::point of view
current will leak::current will leak
send a light::send a light
distortion that means::distortion that means
signal changes shapes::signal changes shapes
bits may overlap::bits may overlap
make recognition impossible::make recognition impossible
signal changes shape::signal changes shape
change the shape::change the shape
square wave kind::square wave kind
harmonics or sign::harmonics or sign
sin x sin::sin x sin
frequencies now signals::frequencies now signals
versa the point::versa the point
pick up noise::pick up noise
energy in wire::energy in wire
kind of inherent::kind of inherent
signals so spikes::signals so spikes
car is starting::car is starting
running a motor::running a motor
running a washing::running a washing
carrying a signal::carrying a signal
change the transmission::change the transmission
original signal back::original signal back
thing may happen::thing may happen
high signal-to-noise ratio::high signal-to-noise ratio
ratio in order::ratio in order
order to distinguish::order to distinguish
signal is high::signal is high
signal-to-noise ratio signal::signal-to-noise ratio signal
ratio signal strength::ratio signal strength
signal strength divided::signal strength divided
average noise strength::average noise strength
error will increase::error will increase
signal becomes weaker::signal becomes weaker
weaker and touches::weaker and touches
touches the noise::touches the noise
strong signal-to-noise ratio::strong signal-to-noise ratio
send a signal::send a signal
naturally get weak::naturally get weak
weak so in-between::weak so in-between
put some amplifiers::put some amplifiers
amplifiers or repeaters::amplifiers or repeaters
repeaters or regenerators::repeaters or regenerators
out the noises::out the noises
amplify the signal::amplify the signal
signal and make::signal and make
regenerate the signals::regenerate the signals
maintain an acceptable::maintain an acceptable
acceptable signal-to-noise ratio::acceptable signal-to-noise ratio
interference that means::interference that means
adds to signal::adds to signal
hard to control::hard to control
control or diagnose::control or diagnose
interference can occur::interference can occur
occur at cable::occur at cable
cables are running::cables are running
running in parallel::running in parallel
affect the signal::affect the signal
kind of linkage::kind of linkage
two the so-called::two the so-called
so-called cross talk::so-called cross talk
terminate the thing::terminate the thing
putting some wired::putting some wired
lot of noise::lot of noise
interference in nearby::interference in nearby
bad at terminations::bad at terminations
terminations where wires::terminations where wires
wires are unwound::wires are unwound
carrying digital data::carrying digital data
data over analog::data over analog
require modems modem::require modems modem
modems modem stands::modems modem stands
stands for modulation::stands for modulation
modulation and demodulation::modulation and demodulation
connect a digital::connect a digital
analog phone system::analog phone system
understand why modems::understand why modems
modems are required::modems are required
system the field::system the field
field of communication::field of communication
details of communications::details of communications
basics of communications::basics of communications
remember computer network::remember computer network
lines so communication::lines so communication
talked about this.in::talked about this.in
deployed in common::deployed in common
ways the digital::ways the digital
signals and analog::signals and analog
communication how digital::communication how digital
data or analog::data or analog
impairments of physical::impairments of physical
basically two types::basically two types
types of mediawhich::types of mediawhich
two different classes::two different classes
cable or twisted::cable or twisted
pair or shielded::pair or shielded
shielded twisted pair::shielded twisted pair
pair or utp::pair or utp
shielded twisted pairs::shielded twisted pairs
cables these days::cables these days
types of cables::types of cables
cables by simple::cables by simple
simple electromagnetic radiation::simple electromagnetic radiation
infrared or microwave::infrared or microwave
microwave or radio::microwave or radio
radio or satellite::radio or satellite
kind of media::kind of media
network could vary::network could vary
means of size::means of size
means two computer::means two computer
two computer connected::two computer connected
computer connected siding::computer connected siding
table connected side::table connected side
side by side::side by side
kind of range::kind of range
talk about find::talk about find
utp or unshielded::utp or unshielded
unshielded twisted pairs::unshielded twisted pairs
varieties or categories::varieties or categories
cat3 cable cat::cat3 cable cat
cable cat 5cable::cable cat 5cable
cat 5e cable::cat 5e cable
connected by unshielded::connected by unshielded
cables of categories::cables of categories
cat three cables::cat three cables
cat five onwards::cat five onwards
onwards the kind::onwards the kind
kind of things::kind of things
local telephone exchange::local telephone exchange
ports etc ethernet::ports etc ethernet
fddi ring kind::fddi ring kind
networks even smaller::networks even smaller
smaller than lan::smaller than lan
personal area networks::personal area networks
networks some networks::networks some networks
spectrum that means::spectrum that means
means from lan::means from lan
metropolitan area network::metropolitan area network
typically one campus::typically one campus
man by ballpark::man by ballpark
ballpark figure man::ballpark figure man
kind of medium::kind of medium
metropolitan area networks::metropolitan area networks
area networks coaxial::area networks coaxial
networks coaxial cables::networks coaxial cables
cables both base::cables both base
band and broadband::band and broadband
connecting although utp::connecting although utp
network to telephone::network to telephone
telephone linesi told::telephone linesi told
kind of system::kind of system
coaxial some part::coaxial some part
fiber fiber means::fiber fiber means
cables and kind::cables and kind
pbx different kinds::pbx different kinds
kinds of modems::kinds of modems
broad band coaxial::broad band coaxial
band coaxial cable::band coaxial cable
ethernet that means::ethernet that means
cable tv dsl::cable tv dsl
dsl digital subscriber::dsl digital subscriber
digital subscriber lines::digital subscriber lines
wireless one issue::wireless one issue
important in man::important in man
issue of access::issue of access
order to network::order to network
network the entire::network the entire
residence and reaching::residence and reaching
individual residence involves::individual residence involves
residence involves cost::residence involves cost
good say utp::good say utp
problems of taking::problems of taking
taking utp cable::taking utp cable
disturbance and things::disturbance and things
question of cost::question of cost
access to users::access to users
issue in metropolitan::issue in metropolitan
fiber or satellite::fiber or satellite
wan are sonet::wan are sonet
sonet or sdh::sonet or sdh
similar technology atm::similar technology atm
dwdm dense wavelength::dwdm dense wavelength
dense wavelength division::dense wavelength division
geo and leo::geo and leo
leo geo stands::leo geo stands
stands for geostationary::stands for geostationary
form of geostationary::form of geostationary
satellite and leo::satellite and leo
leo is low::leo is low
low art orbiting::low art orbiting
art orbiting satellite::art orbiting satellite
orbiting satellite computer::orbiting satellite computer
satellite computer networks::satellite computer networks
.sujoy ghosh dept::.sujoy ghosh dept
dept of computer::dept of computer
science & engineering::science & engineering
good day today::good day today
ways these digital::ways these digital
form of data::form of data
types of media::types of media
classes of cable::classes of cable
pair the twisted::pair the twisted
pairs or utp::pairs or utp
ranges of frequencies::ranges of frequencies
means two computers::means two computers
two computers connected::two computers connected
table or connected::table or connected
lan the medium::lan the medium
talked about find::talked about find
cables of category::cables of category
pbx ; pbx::pbx ; pbx
pbx is local::pbx is local
lan ; atm::lan ; atm
boxes like hubs::boxes like hubs
lan or local::lan or local
slightly bigger networks::slightly bigger networks
man or metropolitan::man or metropolitan
connected in network::connected in network
lan to bigger::lan to bigger
range the kind::range the kind
networks is coaxial::networks is coaxial
network through telephone::network through telephone
telephone lines utp::telephone lines utp
fiber means fiber::fiber means fiber
means fiber optic::means fiber optic
cables the kind::cables the kind
broadband coaxial cable::broadband coaxial cable
access that means::access that means
taking utp cables::taking utp cables
globe they involve::globe they involve
distances the medium::distances the medium
wan is sonet::wan is sonet
protocol ? dwdm::protocol ? dwdm
wan one issue::wan one issue
issue in man::issue in man
cost and bandwidth::cost and bandwidth
message across hundreds::message across hundreds
hundreds of thousands::hundreds of thousands
thousands of kilometers::thousands of kilometers
lot of cost::lot of cost
make the maximum::make the maximum
recent times lot::recent times lot
lot of fiber::lot of fiber
wan bandwidth remains::wan bandwidth remains
bandwidth remains costly::bandwidth remains costly
cable of category::cable of category
utp cables specification::utp cables specification
things little bit::things little bit
kind of idea::kind of idea
standard telephone cable::standard telephone cable
slightly better specification::slightly better specification
specification the connector::specification the connector
specific scientific number::specific scientific number
connectors for connecting::connectors for connecting
ansi or tia::ansi or tia
tia or eia::tia or eia
number of wires::number of wires
inside the twisted::inside the twisted
pair of cables::pair of cables
standards ; tsb::standards ; tsb
standard for testing::standard for testing
testing cables cat::testing cables cat
mbps the point::mbps the point
cable can work::cable can work
speed so inside::speed so inside
room the cat::room the cat
connection between computers::connection between computers
computers or network::computers or network
version of cat::version of cat
higher than cat::higher than cat
mhz this specification::mhz this specification
costlier than cat::costlier than cat
kind of connector::kind of connector
cable for operating::cable for operating
point when networking::point when networking
networks a lot::networks a lot
mbps now people::mbps now people
mbps is slow::mbps is slow
comparatively short period::comparatively short period
demand for bandwidth::demand for bandwidth
bandwidth has grown::bandwidth has grown
grown a thousand-fold::grown a thousand-fold
people are giving::people are giving
giving you today::giving you today
put in cat::put in cat
saving a lot::saving a lot
higher upfront cost::higher upfront cost
upfront cost today::upfront cost today
testing these kind::testing these kind
kinds of testing::kinds of testing
technical part return::technical part return
part return loss::part return loss
reflected energy caused::reflected energy caused
caused by impedance::caused by impedance
put a cabling::put a cabling
talk as reflected::talk as reflected
elfext is defined::elfext is defined
measure of signal::measure of signal
neighboring pair measured::neighboring pair measured
received signal level::received signal level
pair these kinds::pair these kinds
testing copper cables::testing copper cables
put fiber optic::put fiber optic
idea to test::idea to test
test the passive::test the passive
passive networking infrastructure::passive networking infrastructure
cables and connections::cables and connections
base band coaxial::base band coaxial
band coaxial cables::band coaxial cables
basically a shielded::basically a shielded
copper cord surrounded::copper cord surrounded
surrounded by braided::surrounded by braided
braided outer conductor::braided outer conductor
protective outer covering::protective outer covering
so-called thick coaxial::so-called thick coaxial
cable and thin::cable and thin
cable this technology::cable this technology
meters the thin::meters the thin
case this thick::case this thick
thick and thin::thick and thin
thin coaxial cables::thin coaxial cables
type of coaxial::type of coaxial
cable operator puts::cable operator puts
puts some kind::puts some kind
kind of coaxial::kind of coaxial
infrastructure for computer::infrastructure for computer
networking also remember::networking also remember
issues in metropolitan::issues in metropolitan
reach each individual::reach each individual
operator has reached::operator has reached
lot of homes::lot of homes
people started thinking::people started thinking
operators for network::operators for network
modems were designed::modems were designed
broadband cable infrastructure::broadband cable infrastructure
cities for computer::cities for computer
analog signal carrying::analog signal carrying
carrying tv signals::carrying tv signals
carrying data traffic::carrying data traffic
data traffic older::data traffic older
traffic older cables::traffic older cables
older cables carry::older cables carry
cables use amplifiers::cables use amplifiers
amplifiers at regular::amplifiers at regular
cable operators wanted::cable operators wanted
broadcasting their signal::broadcasting their signal
communication the communication::communication the communication
requires an amplifier::requires an amplifier
amplifier at regular::amplifier at regular
medium is shared::medium is shared
dual cable systems::dual cable systems
providers ? equipments::providers ? equipments
kinds of split::kinds of split
mhz for inbound::mhz for inbound
rest for outbound::rest for outbound
traffic ; mid-split::traffic ; mid-split
kinds of systems::kinds of systems
asymmetry that people::asymmetry that people
people have found::people have found
computer network nowadays::computer network nowadays
amount of traffic::amount of traffic
traffic in terms::traffic in terms
terms of query::terms of query
downloading large files::downloading large files
upstream bandwidth requirement::upstream bandwidth requirement
downstream bandwidth requirement::downstream bandwidth requirement
looked at copper::looked at copper
optical fibers optical::optical fibers optical
fibers optical fiber::fibers optical fiber
basically is made::basically is made
made of glass::made of glass
transparent silica glass::transparent silica glass
tens of kilometers::tens of kilometers
kind of transparency::kind of transparency
transparency is required::transparency is required
standards for making::standards for making
making this glass::making this glass
simply a glass::simply a glass
drawn into fiber::drawn into fiber
fiber for giving::fiber for giving
fiber at moderate::fiber at moderate
light is restricted::light is restricted
total internal reflection::total internal reflection
reflection for ordinary::reflection for ordinary
guide for lasers::guide for lasers
single-mode fiber multimode::single-mode fiber multimode
fiber multimode fibers::fiber multimode fibers
networks these days::networks these days
days single-mode fibres::days single-mode fibres
preferred for carrying::preferred for carrying
fibers or free::fibers or free
free space free::free space free
space free space::space free space
free space means::free space means
space means suppose::space means suppose
suppose you direct::suppose you direct
direct a laser::direct a laser
light will travel::light will travel
reach the receiver::reach the receiver
problem the first::problem the first
first obvious problem::first obvious problem
line of sight::line of sight
index may change::index may change
desert that kind::desert that kind
miss the receiver::miss the receiver
altogether so free::altogether so free
free space optic::free space optic
space optic communication::space optic communication
preferred people prefer::preferred people prefer
prefer to put::prefer to put
cables or free::cables or free
fiber optic transmission::fiber optic transmission
question of optical::question of optical
provide the network::provide the network
network level functionalities::network level functionalities
topic of research::topic of research
research these days::research these days
optical fiber capacity::optical fiber capacity
capacity is huge::capacity is huge
absolutely fantastic bandwidth::absolutely fantastic bandwidth
put a fiber::put a fiber
fiber optic connection::fiber optic connection
endpoints your present::endpoints your present
foreseable future requirements::foreseable future requirements
surely be met::surely be met
thing about optics::thing about optics
immune to electromagnetic::immune to electromagnetic
strand of glass::strand of glass
reason people favor::reason people favor
people favor fiber::people favor fiber
favor fiber optics::favor fiber optics
optics a lot::optics a lot
make much sense::make much sense
ultimately be dictated::ultimately be dictated
kind of boxes::kind of boxes
electronics now electronics::electronics now electronics
kind of speed::kind of speed
speed a single::speed a single
piece of electronics::piece of electronics
fiber would depend::fiber would depend
kind of electronics::kind of electronics
lot of interest::lot of interest
interest these days::interest these days
replaced by optics::replaced by optics
multiplexing that means::multiplexing that means
means different wavelengths::means different wavelengths
wavelengths of light::wavelengths of light
carry different signals::carry different signals
fiber optic channel::fiber optic channel
kind of bandwidth::kind of bandwidth
kinds of wavelength::kinds of wavelength
coarse wavelength division::coarse wavelength division
costly sothe number::costly sothe number
number of wavelengths::number of wavelengths
people are working::people are working
ultra dense wavelength::ultra dense wavelength
laser was discovered::laser was discovered
mid-60s guided wave::mid-60s guided wave
guided wave optics::guided wave optics
optics was demonstrated::optics was demonstrated
production of low::production of low
low loss fibers::low loss fibers
made long-distance optical::made long-distance optical
long-distance optical transmission::long-distance optical transmission
invention of semi::invention of semi
semi conductor laser::semi conductor laser
conductor laser diode::conductor laser diode
fiber in telephony::fiber in telephony
form of sonet::form of sonet
lans and man::lans and man
man were sort::man were sort
put in place::put in place
optically amplifying optical::optically amplifying optical
amplifying optical signals::amplifying optical signals
edfa and rbm::edfa and rbm
dot fiber amplifier::dot fiber amplifier
mid to late::mid- to late
division multiplexing system::division multiplexing system
multiplexing system started::multiplexing system started
started being put::started being put
21st century optical::21st century optical
century optical switching::century optical switching
optical switching systems::optical switching systems
components of optical::components of optical
lot of work::lot of work
productive jacket made::productive jacket made
made of plastic::made of plastic
inside this cladding::inside this cladding
carries the signal::carries the signal
sides and core::sides and core
sort of cut::sort of cut
cut it side::cut it side
kind of picture::kind of picture
core it sort::core it sort
sort of refracts::sort of refracts
angle of incidence::angle of incidence
higher refractive index::higher refractive index
cladding at lower::cladding at lower
lower refractive index::lower refractive index
follow this fiber::follow this fiber
bend this core::bend this core
radius of curvature::radius of curvature
reflection the light::reflection the light
light will follow::light will follow
follow this core::follow this core
picture ? light::picture ? light
light is input::light is input
connect these fiber::connect these fiber
ways of termination::ways of termination
terminate a fiber::terminate a fiber
fiber by plugging::fiber by plugging
sort of clamping::sort of clamping
mechanically by putting::mechanically by putting
two cut ends::two cut ends
sleeve and clamping::sleeve and clamping
form a solid::form a solid
method of connecting::method of connecting
kind of disturbance::kind of disturbance
two different light::two different light
lasers and light::lasers and light
light emitting diodes::light emitting diodes
give non-coherent lights::give non-coherent lights
laser ? laser::laser ? laser
light and simple::light and simple
rate for lasers::rate for lasers
higher with lasers::higher with lasers
low fiber type::low fiber type
fibers we prefer::fibers we prefer
prefer single mode::prefer single mode
single mode fibres::single mode fibres
fibres for lasers::fibres for lasers
lasers the distance::lasers the distance
led can cover::led can cover
cover is short::cover is short
distance that single::distance that single
single mode fiber::single mode fiber
single mode types::single mode types
higher and higher::higher and higher
tend to prefer::tend to prefer
fibers these days::fibers these days
short if proper::short if proper
years the temperature::years the temperature
sensitivity for led::sensitivity for led
led is minor::led is minor
naturally is low::naturally is low
cost and laser::cost and laser
kind of losses::kind of losses
discussing about electrical::discussing about electrical
kinds of distortion::kinds of distortion
longer and longer::longer and longer
case of fiber::case of fiber
fiber its strength::fiber its strength
phenomena of rayleigh::phenomena of rayleigh
due to slight::due to slight
kinds of scattering::kinds of scattering
scattering called mie::scattering called mie
mie scattering due::mie scattering due
structure these losses::structure these losses
end your signal::end your signal
signal will arrive::signal will arrive
slightly distorted fashion::slightly distorted fashion
loss is quiet::loss is quiet
find some kind::find some kind
kind of windows::kind of windows
loss is low::loss is low
amplification or repeated::amplification or repeated
kind of action::kind of action
make the thing::make the thing
data for longer::data for longer
send our signal::send our signal
high frequencies involved::high frequencies involved
devices and boxes::devices and boxes
fiber optic signal::fiber optic signal
kind of source::kind of source
quality of fiber::quality of fiber
kind of repeater::kind of repeater
signal may amplify::signal may amplify
amplify or make::amplify or make
make the shape::make the shape
shape all right::shape all right
kinds of repeaters::kinds of repeaters
function in order::function in order
repeat optical signals::repeat optical signals
signals ? optical::signals ? optical
optical signals traveling::optical signals traveling
distances through fiber::distances through fiber
done through olts::done through olts
optical line transmitter::optical line transmitter
takes the signal::takes the signal
make a nice::make a nice
nice and strong::nice and strong
strong wave form::strong wave form
form and push::form and push
journey the important::journey the important
advantage of doing::advantage of doing
limitations of electronics::limitations of electronics
erbium doped fiber::erbium doped fiber
doped fiber amplifiers::doped fiber amplifiers
amplifiers so erbium::amplifiers so erbium
number of excited::number of excited
meters of optical::meters of optical
fiber are doped::fiber are doped
means a small::means a small
erbium is introduced::erbium is introduced
glass is doped::glass is doped
million of erbium::million of erbium
carrying the signal::carrying the signal
doped with erbium::doped with erbium
frequency is fed::frequency is fed
sort of induces::sort of induces
induces the erbium::induces the erbium
giving an amplified::giving an amplified
erbium doped amplification::erbium doped amplification
kind of pump::kind of pump
kind of excited::kind of excited
basic idea remains::basic idea remains
dispersion and polarization::dispersion and polarization
mode dispersion wave::mode dispersion wave
dispersion wave shaping::dispersion wave shaping
kinds of combination::kinds of combination
combination of wave::combination of wave
specially to match::specially to match
match the dispersion::match the dispersion
characteristics of fiber::characteristics of fiber
long distance distortion::long distance distortion
counteracted by reverse::counteracted by reverse
kinds of technology::kinds of technology
up-coming and growing::up-coming and growing
repeaters are needed::repeaters are needed
kilometers as opposed::kilometers as opposed
kilometers for copper::kilometers for copper
affected by power::affected by power
simplex that means::simplex that means
fiber the data::fiber the data
require a pair::require a pair
pair of fibers::pair of fibers
strands of twisted::strands of twisted
people are putting::people are putting
ultra long hall::ultra long hall
hall ? ultra::hall ? ultra
long hall means::long hall means
wdm or sonet::wdm or sonet
fiber is finding::fiber is finding
means to individual::means to individual
fibers can reach::fibers can reach
reach your home::reach your home
goal of networking::goal of networking
fibers to homes::fibers to homes
concept of passive::concept of passive
passive optical networking::passive optical networking
keeping a switch::keeping a switch
put a passive::put a passive
sort of splitter::sort of splitter
splits the signal::splits the signal
passive optical network::passive optical network
important physical medium::important physical medium
wireless one disadvantage::wireless one disadvantage
data transmission methods::data transmission methods
wired connections moving::wired connections moving
wireless connection results::wireless connection results
ability to connect::ability to connect
connect a network::connect a network
mobility that means::mobility that means
entire electromagnetic spectrum::entire electromagnetic spectrum
shows a picture::shows a picture
kind of frequencies::kind of frequencies
range is tremendous::range is tremendous
ultra high frequency::ultra high frequency
super high frequency::super high frequency
extremely high frequency::extremely high frequency
data is transmitted::data is transmitted
means the higher::means the higher
higher the frequency::higher the frequency
encoded and transmitted::encoded and transmitted
transmitted narrow band::transmitted narrow band
watts is high::NNP is high
transmitter to jump::transmitter to jump
order to avoid::order to avoid
avoid communication jams::avoid communication jams
wireless lan standard::wireless lan standard
easy to generate::easy to generate
travels long distances::travels long distances
omni directional antenna::omni directional antenna
send your signal::send your signal
frequency like microwave::frequency like microwave
walls and power::walls and power
sharply with distance::sharply with distance
source at high::source at high
high frequencies waves::high frequencies waves
waves will bounce::waves will bounce
wave can cover::wave can cover
bands are limited::bands are limited
limited by distance::limited by distance
back to earth::back to earth
happen in short-wave::happen in short-wave
short wave radio::short wave radio
transmission from usa::transmission from usa
ionosphere and reaching::ionosphere and reaching
kind of attenuation::kind of attenuation
thing called multipath::thing called multipath
signal may reach::signal may reach
out of phase::out of phase
sort of cancel::sort of cancel
problems we encounter::problems we encounter
encounter in mobile::encounter in mobile
focused so data::focused so data
alignment is important::alignment is important
receiver will miss::receiver will miss
miss the signal::miss the signal
signal altogether beams::signal altogether beams
pass through buildings::pass through buildings
disadvantages of microwave::disadvantages of microwave
waves are delayed::waves are delayed
out of sync::out of sync
infrared and millimeter::infrared and millimeter
talked about optical::talked about optical
pass through solid::pass through solid
advantage or disadvantage::advantage or disadvantage
sort of send::sort of send
send the signal::send the signal
signal from earth::signal from earth
earth these satellites::earth these satellites
sort of low::sort of low
earth orbiting satellites::earth orbiting satellites
rest is part::rest is part
part of lec::part of lec
faculty name prof::faculty name prof
prof sujoy ghosh::prof sujoy ghosh
shareing a medium::shareing a medium
talk about multiplexing::talk about multiplexing
medium that means::medium that means
means different users::means different users
users are sharing::users are sharing
condition a medium::condition a medium
medium can carry::medium can carry
signals can share::signals can share
medium the medium::medium the medium
giving each signal::giving each signal
senders and receivers::senders and receivers
individually the require::individually the require
users their requirement::users their requirement
requirement are aggregated::requirement are aggregated
substantial band width::substantial band width
current technique accomplish::current technique accomplish
accomplish this includes::accomplish this includes
includes frequency division::includes frequency division
division multiplexing wavelength::division multiplexing wavelength
multiplexing wavelength division::multiplexing wavelength division
multiplexing time division::multiplexing time division
two different lines::two different lines
sender receiver pair::sender receiver pair
pair is utilizing::pair is utilizing
types of multiplexer::types of multiplexer
statistical time division::statistical time division
multiplexing each user::multiplexing each user
bandwidth that means::bandwidth that means
means the entire::means the entire
channel is dedicated::channel is dedicated
sujoy ghosh indian::sujoy ghosh indian
technology iit kharagpur::technology iit kharagpur
iit kharagpur lecture::iit kharagpur lecture
bandwidth to facilitate::bandwidth to facilitate
expensive ? leased::expensive ? leased
packet switching networks::packet switching networks
laying of lines::laying of lines
saves a lot::saves a lot
requirements are aggregated::requirements are aggregated
sender ? receiver::sender ? receiver
physical link in-between::physical link in-between
direct point-to-point connection::direct point-to-point connection
problems the first::problems the first
floors another important::floors another important
line the host::line the host
host polls machines::host polls machines
saves i port::saves -NONE- port
data is multiplexed::data is multiplexed
number of lines::number of lines
multiplexing ; tdm::multiplexing ; tdm
multiplexing ; stdm::multiplexing ; stdm
spectrum is divided::spectrum is divided
number of logical::number of logical
channel is divided::channel is divided
user has exclusive::user has exclusive
fdm sends signals::fdm sends signals
distinct frequency ranges::distinct frequency ranges
radiation can pass::radiation can pass
pass electromagnetic radiation::pass electromagnetic radiation
range of bandwidth::range of bandwidth
so-called radio frequencies::so-called radio frequencies
radio frequencies constitute::radio frequencies constitute
constitute one part::constitute one part
fairly important part::fairly important part
bandwidth of radio::bandwidth of radio
frequencies is divided::frequencies is divided
divided into small::divided into small
tune our radio::tune our radio
number of stations::number of stations
cable tv providers::cable tv providers
give one cable::give one cable
apparently is carrying::apparently is carrying
carrying a number::carrying a number
number of channels::number of channels
hundreds of channels::hundreds of channels
channels these days::channels these days
carry multiple video::carry multiple video
multiple video channels::multiple video channels
out of question::out of question
imagine the cost::imagine the cost
cost of stringing::cost of stringing
hundred cables coming::hundred cables coming
signal is modulated::signal is modulated
frequency ; carrier::frequency ; carrier
frequencies are separated::frequencies are separated
separated by guard::separated by guard
bands this guard::bands this guard
band is important::band is important
range of frequencies::range of frequencies
occupy ; first::occupy ; first
non-overlapping the range::non-overlapping the range
separation in frequencies::separation in frequencies
transmission medium exceeds::transmission medium exceeds
medium exceeds required::medium exceeds required
exceeds required bandwidth::exceeds required bandwidth
transmit signals broadcast::transmit signals broadcast
signals broadcast radio::signals broadcast radio
radio and television::radio and television
television and amps::television and amps
amps cellular phone::amps cellular phone
cellular phone system::cellular phone system
system use frequency::system use frequency
division multiplexing amps::division multiplexing amps
kind of cellular::kind of cellular
complex multiplexing techniques::complex multiplexing techniques
multiplexing this technique::multiplexing this technique
assignment of non-overlapping::assignment of non-overlapping
non-overlapping frequency ranges::non-overlapping frequency ranges
user or signal::user or signal
signals are transmitted::signals are transmitted
frequencies a multiplexer::frequencies a multiplexer
multiplexer accepts inputs::multiplexer accepts inputs
inputs and assigns::inputs and assigns
multiplexer is attached::multiplexer is attached
high-speed communications line::high-speed communications line
bands on individual::bands on individual
frequencies the communication::frequencies the communication
multiplexer or demultiplexer::multiplexer or demultiplexer
line and separates::line and separates
separates the multiplexed::separates the multiplexed
separate them out::separate them out
involves analog signaling::involves analog signaling
susceptible to noise::susceptible to noise
noise in digital::noise in digital
sort of clean::sort of clean
clean the noise::clean the noise
noise more easily::noise more easily
dedicated to user::dedicated to user
frequency ? frequency::frequency ? frequency
divided into logical::divided into logical
radio are examples::radio are examples
mechanism of extending::mechanism of extending
send some signals::send some signals
versus the signal::versus the signal
in-between this part::in-between this part
so-called guard band::so-called guard band
band this frequency::band this frequency
due to noise::due to noise
diagram which shows::diagram which shows
guard bands in-between::guard bands in-between
multiplexer ? demultiplexer::multiplexer ? demultiplexer
problem with fdm::problem with fdm
utilize the full::utilize the full
give the guard::give the guard
summarize these advantages::summarize these advantages
sort of bit::sort of bit
bit more prone::bit more prone
prone to noise::prone to noise
dealing with analog::dealing with analog
analog signals fdm::analog signals fdm
carry analog signals::carry analog signals
signals although modulated::signals although modulated
modulated digital signals::modulated digital signals
type of multiplexing::type of multiplexing
multiplexing only thing::multiplexing only thing
means different frequencies::means different frequencies
doing wavelength division::doing wavelength division
doing frequency division::doing frequency division
fdm but applied::fdm but applied
applied to fibers::applied to fibers
potential for fibers::potential for fibers
slight percentage diviation::slight percentage diviation
sort of compact::sort of compact
compact or pack::compact or pack
pack a lot::pack a lot
lot of channels::lot of channels
high frequencies fibers::high frequencies fibers
large bandwidth capacity::large bandwidth capacity
bands are passed::bands are passed
diffraction grating prism::diffraction grating prism
grating prism combined::grating prism combined
long distant link::long distant link
two very interesting::two very interesting
multiplexing and demultiplexing::multiplexing and demultiplexing
send a white::send a white
prism it breaks::prism it breaks
prism to break::prism to break
shown a prism::shown a prism
plot the power::plot the power
versus the frequency::versus the frequency
fiber maybe giving::fiber maybe giving
fiber maybe delivering::fiber maybe delivering
kind of plot::kind of plot
division multiplexing multiplexes::division multiplexing multiplexes
multiplexing multiplexes multiple::multiplexing multiplexes multiple
multiplexes multiple data::multiplexes multiple data
multiple data streams::multiple data streams
single fiber optic::single fiber optic
fiber optic line::fiber optic line
line different wavelength::line different wavelength
denoting a wavelength::denoting a wavelength
optical communication domain::optical communication domain
domain different frequencies::domain different frequencies
transmit multiple signals::transmit multiple signals
signals each signal::signals each signal
thing of fiber::thing of fiber
separated what rate::separated what rate
rate of data::rate of data
mentioned that fiber::mentioned that fiber
people are finding::people are finding
ways of packing::ways of packing
pack those wavelengths::pack those wavelengths
costly a cheaper::costly a cheaper
cwdm so dense::cwdm so dense
multiplexing or cwdm::multiplexing or cwdm
cwdm the channels::cwdm the channels
important multiplexing technique::important multiplexing technique
communication or telecommunication::communication or telecommunication
telecommunication time division::telecommunication time division
service provider side::service provider side
signal is accomplished::signal is accomplished
multiplexing by dividing::multiplexing by dividing
medium among users::medium among users
turn to send::turn to send
burst of data::burst of data
data or voice::data or voice
exclusively time division::exclusively time division
two basic forms::two basic forms
synchronous time division::synchronous time division
statistical or asynchronous::statistical or asynchronous
asynchronous time division::asynchronous time division
division multiplexing first::division multiplexing first
slicing this channel::slicing this channel
divided ; channel::divided ; channel
entire frequency range::entire frequency range
turn of channel::turn of channel
sends the first::sends the first
entire frequency band::entire frequency band
system like fdm::system like fdm
fdm time division::fdm time division
division multiplexing saves::division multiplexing saves
multiplexing saves money::multiplexing saves money
money by allowing::money by allowing
side this sequence::side this sequence
slot for receiver::slot for receiver
synchronous division multiplexing::synchronous division multiplexing
dividing the cable::dividing the cable
cable frequency bands::cable frequency bands
tdm splits cable::tdm splits cable
splits cable usage::splits cable usage
slots each channel::slots each channel
regular time slot::regular time slot
send a pcm::send a pcm
hierarchy of manner::hierarchy of manner
digital signals discussion::digital signals discussion
double the rate::double the rate
converted each sample::converted each sample
bit digital signal::bit digital signal
pcm ? pulse::pcm ? pulse
pulse coded modulation::pulse coded modulation
modulation that means::modulation that means
amplitude of voice::amplitude of voice
bits per sample::bits per sample
rate a number::rate a number
higher level channel::higher level channel
higher lever channels::higher lever channels
make a hierarchy::make a hierarchy
hierarchy of channels::hierarchy of channels
world wide standards::world wide standards
sort of join::sort of join
form a stream::form a stream
kind of frame::kind of frame
bandwidth is increasing::bandwidth is increasing
signals or analog::signals or analog
analog signals carrying::analog signals carrying
signals carrying digital::signals carrying digital
rate of transmission::rate of transmission
transmission media exceeds::transmission media exceeds
media exceeds data::media exceeds data
exceeds data rate::exceeds data rate
rate of signals::rate of signals
send whatever digital::send whatever digital
buffer or kind::buffer or kind
make it empty::make it empty
accumulate the bits::accumulate the bits
bits thus data::bits thus data
exceed data rate::exceed data rate
frame ; frame::frame ; frame
means a number::means a number
bits and bytes::bits and bytes
slot will send::slot will send
send a lower::send a lower
device will send::device will send
send a large::send a large
device is equal::device is equal
equal to channel::equal to channel
slots are transmitted::slots are transmitted
transmitted whether source::transmitted whether source
source has data::source has data
side is blind::side is blind
send those bits::send those bits
bits to receiver::bits to receiver
round robin fashion::round robin fashion
suppose the senders::suppose the senders
scheme of things::scheme of things
sort of address::sort of address
original time division::original time division
multiplexer accepts input::multiplexer accepts input
input from attached::input from attached
fashion and transmit::fashion and transmit
isdn telephone lines::isdn telephone lines
lines are common::lines are common
examples of synchronous::examples of synchronous
device generates data::device generates data
sample the incoming::sample the incoming
incoming data stream::incoming data stream
devices or buffer::devices or buffer
buffer the faster::buffer the faster
faster incoming stream::faster incoming stream
transmit the multiplexer::transmit the multiplexer
insert a piece::insert a piece
piece of data::piece of data
kind of tdm::kind of tdm
hybrid multiplexing schemes::hybrid multiplexing schemes
entire available channels::entire available channels
number of bands::number of bands
band is allotted::band is allotted
combination of fdm::combination of fdm
fdm and tdm::fdm and tdm
kind of hybrid::kind of hybrid
hybrid multiplexing systems::hybrid multiplexing systems
cell phone communication::cell phone communication
kind of multiplexing::kind of multiplexing
hybrid multiplexing system::hybrid multiplexing system
channel is broken::channel is broken
band multiple channels::band multiple channels
channels are accommodated::channels are accommodated
accommodated through tdm::accommodated through tdm
basis and packets::basis and packets
sources are interweaved::sources are interweaved
mentioned the disadvantage::mentioned the disadvantage
pure time division::pure time division
addressed in statistical::addressed in statistical
multiplexing or stdm::multiplexing or stdm
channel is free::channel is free
kind of scheduling::kind of scheduling
simple vanilla case::simple vanilla case
utilizes the channel::utilizes the channel
slot being allotted::slot being allotted
inside that data::inside that data
stream that means::stream that means
inside the data::inside the data
tells the receiver::tells the receiver
making a sound::making a sound
quiescent that means::quiescent that means
rate of utilization::rate of utilization
world of sending::world of sending
sending and receiving::sending and receiving
receiving data data::receiving data data
data data traffic::data data traffic
computer is communicating::computer is communicating
lot of stuff::lot of stuff
sees that data::sees that data
sends another burst::sends another burst
burst and in-between::burst and in-between
in-between these bursts::in-between these bursts
people can share::people can share
nodes will transmit::nodes will transmit
transmit at full::transmit at full
transmit a terminal::transmit a terminal
two different sources::two different sources
land up hoping::land up hoping
making a queue::making a queue
number of packets::number of packets
strict round robin::strict round robin
packet or cell::packet or cell
queue is processed::queue is processed
kinds of possibilities::kinds of possibilities
decide to send::decide to send
statistical multiplexer transmits::statistical multiplexer transmits
data from active::data from active
active work stations::active work stations
space is wasted::space is wasted
statistical multiplexer accepts::statistical multiplexer accepts
accepts the incoming::accepts the incoming
incoming data streams::incoming data streams
streams and creates::streams and creates
creates a frame::creates a frame
kind of destination::kind of destination
identify each piece::identify each piece
address is included::address is included
lengths are fixed::lengths are fixed
systems like atm::systems like atm
size is fixed::size is fixed
size may vary::size may vary
include the length::include the length
part is fixed::part is fixed
summarize the advantages::summarize the advantages
beginning i mentioned::beginning i mentioned
talk about code::talk about code
talk about multiple::talk about multiple
blurred these days::blurred these days
sources are sort::sources are sort
sort of converged::sort of converged
sense the sources::sense the sources
sources are converged::sources are converged
number of telephone::number of telephone
users are distributed::users are distributed
case we call::case we call
multiple access system::multiple access system
access system cdma::access system cdma
slowly getting blurred::slowly getting blurred
doing some kind::doing some kind
doing some hybrid::doing some hybrid
tdm ; i.e::tdm ; i.e
bands of frequencies::bands of frequencies
carrying some wireless::carrying some wireless
carrying their mobile::carrying their mobile
distinction between multiplexing::distinction between multiplexing
multiplexing and multiple::multiplexing and multiple
discuss code division::discuss code division
multiplexing or multiple::multiplexing or multiple
kinds of multiple::kinds of multiple
division multiple access::division multiple access
frequency division multiple::frequency division multiple
code division multiple::code division multiple
advantages and good::advantages and good
schemes ? fdm::schemes ? fdm
oldest multiplexing technique::oldest multiplexing technique
technique your radio::technique your radio
specifically for digital::specifically for digital
digital signals tdm::digital signals tdm
advantage of tdm::advantage of tdm
require different levels::require different levels
levels of bandwidth::levels of bandwidth
bandwidth and speed::bandwidth and speed
communicate or make::communicate or make
make an std::make an std
exchanges are coming::exchanges are coming
coming and converging::coming and converging
exchange is communicating::exchange is communicating
big trunk exchange::big trunk exchange
lot of tributaries::lot of tributaries
doing time division::doing time division
means the rate::means the rate
end is sending::end is sending
flowing in small::flowing in small
channel we require::channel we require
require a multiplexing::require a multiplexing
hierarchies are easy::hierarchies are easy
easy to implement::easy to implement
talk about synchronous::talk about synchronous
synchronous digital hierarchy::synchronous digital hierarchy
talking about advantages::talking about advantages
talk about disadvantages::talk about disadvantages
specially data usage::specially data usage
usage and usage::usage and usage
usage in general::usage in general
wasting the channel::wasting the channel
channel whereas stdm::channel whereas stdm
stdm is making::stdm is making
thing about stdm::thing about stdm
stdm another advantage::stdm another advantage
advantage of stdm::advantage of stdm
putting a frame::putting a frame
kinds of control::kinds of control
advantages of stdm::advantages of stdm
varying size cells::varying size cells
cells in atm::cells in atm
form of fdm::form of fdm
low noise sensitivity::low noise sensitivity
optical domain suppose::optical domain suppose
motor has started::motor has started
lightning somewhere nearby::lightning somewhere nearby
wire will catch::wire will catch
immune to noise::immune to noise
capacity using dwdm::capacity using dwdm
lot of bandwidth::lot of bandwidth
bandwidth is wasted::bandwidth is wasted
limited frequency range::limited frequency range
range in tdm::range in tdm
stdm takes care::stdm takes care
stdm a lot::stdm a lot
lot when high::lot when high
costly than tdm::costly than tdm
tdm and fdm::tdm and fdm
cost is coming::cost is coming
means the wdm::means the wdm
costly than stdm::costly than stdm
multiplexing techniques today::multiplexing techniques today
kinds of communication::kinds of communication
network because remember::network because remember
traditionally for people::traditionally for people
talking over telephones::talking over telephones
network which carries::network which carries
wide area data::wide area data
area data traffic::area data traffic
data traffic today::data traffic today
lecture computers networks::lecture computers networks
talk about telecom::talk about telecom
means the kind::means the kind
discuss this telecom::discuss this telecom
sense that first::sense that first
network even today::network even today
wide area communication::wide area communication
exclusive data networks::exclusive data networks
evolution of telecom::evolution of telecom
alexander graham bell::alexander graham bell
graham bell developed::graham bell developed
developed the first::developed the first
couple of telephone::couple of telephone
telephone instruments connected::telephone instruments connected
connected by wire::connected by wire
people that means::people that means
taking this principle::taking this principle
connecting or stringing::connecting or stringing
stringing a wire::stringing a wire
pair of telephones::pair of telephones
good long term::good long term
long term strategy::long term strategy
jungle of wires::jungle of wires
difficult to manage::difficult to manage
central switching office::central switching office
operator could connect::operator could connect
connect one telephone::connect one telephone
approximately n2 kind::approximately n2 kind
kind of links::kind of links
number of links::number of links
question of connecting::question of connecting
mentioned this earlier::mentioned this earlier
network for data::network for data
data from computers::data from computers
area network traffic::area network traffic
traffic still rides::traffic still rides
sort of made::sort of made
connection is dedicated::connection is dedicated
networks are based::networks are based
networks and telecom::networks and telecom
networks the telecom::networks the telecom
process of routing::process of routing
kinds of calls::kinds of calls
dsl at subscriber::dsl at subscriber
subscriber end voice::subscriber end- voice
end voice traffic::end- voice traffic
traffic is transmitted::traffic is transmitted
transmitted as standard::transmitted as standard
standard analog telephony::standard analog telephony
analog telephony signals::analog telephony signals
signals ; data::signals ; data
modem that transmits::modem that transmits
transmits the data::transmits the data
data as high::data as high
high frequency digital::high frequency digital
frequency digital broadband::frequency digital broadband
digital broadband signals::digital broadband signals
unlike very ordinary::unlike very ordinary
ordinary analog lines::ordinary analog lines
central office end::central office end
local loop management::local loop management
loop management system::loop management system
system the subscriber::system the subscriber
subscriber line access::subscriber line access
line access multiplexer::line access multiplexer
broadband digital signals::broadband digital signals
signals are directed::signals are directed
dslam that terminates::dslam that terminates
terminates and coordinates::terminates and coordinates
traffic from multiple::traffic from multiple
multiple local loop::multiple local loop
local loop lines::local loop lines
functions like giving::functions like giving
giving the connections::giving the connections
connections and testing::connections and testing
kind of testing::kind of testing
testing are done::testing are done
computer networks::computer networks
sujoy ghosh::sujoy ghosh
ghosh lecture::ghosh lecture
network topology::network topology
good day::good day
quick recap::quick recap
computer network::computer network
communication links::communication links
graph representing::graph representing
one-to-one communication::one-to-one communication
structure formed::structure formed
nodes connected::nodes connected
subject matter::subject matter
discussion today::discussion today
graph nodes::graph nodes
represent computer::represent computer
network devices::network devices
links represent::links represent
represent communication::represent communication
links modes::links modes
lan topologies::lan topologies
topologies lan::topologies lan
local area::local area
area network::area network
network topologies::network topologies
bus topology::bus topology
simple kind::simple kind
shared broadcast::shared broadcast
broadcast link::broadcast link
point-to-point communication::point-to-point communication
communicating nodes::communicating nodes
distributed protocol::distributed protocol
broadcast medium::broadcast medium
clear signal::clear signal
simplest thing::simplest thing
single cable::single cable
cable connects::cable connects
shared cable::shared cable
simple network::simple network
single copper::single copper
cable segment::cable segment
properly terminated::properly terminated
unwanted noise::unwanted noise
coaxial cable::coaxial cable
coaxial cables::coaxial cables
thin coaxial::thin coaxial
thin lan::thin lan
thick coaxial::thick coaxial
thick lan::thick lan
extra stations::extra stations
daisy chain::daisy chain
chain manner::chain manner
thick lans::thick lans
main reason::main reason
loose connection::loose connection
shared medium::shared medium
single broadcast::single broadcast
thin ethernet::thin ethernet
mbps speed::mbps speed
maximum range::maximum range
segment length::segment length
maximum number::maximum number
total cable::total cable
cable length::cable length
long cable::long cable
signal travels::signal travels
incoming weak::incoming weak
weak signal::weak signal
stronger signal::stronger signal
thick ethernet::thick ethernet
thin net::thin net
simple cable::simple cable
add stations::add stations
small networks::small networks
longer recommended::longer recommended
limited number::limited number
cable slows::cable slows
response rates::response rates
communication channels::communication channels
complete graph::complete graph
point-to-point network::point-to-point network
dedicated link::dedicated link
packet formats::packet formats
total length::total length
previous thin::previous thin
network suppose::network suppose
mesh topology::mesh topology
computer takes::computer takes
takes turns::takes turns
orderly fashion::orderly fashion
division multiplexing::division multiplexing
shared channel::shared channel
star topology::star topology
central hub::central hub
stage mention::stage mention
physical topology::physical topology
logical topology::logical topology
practical utility::practical utility
cable connections::cable connections
central point::central point
long running::long running
loose connections::loose connections
out failures::out failures
bit difficult::bit difficult
physical star::physical star
logical bus::logical bus
important thing::important thing
central node::central node
previous star::previous star
star diagram::star diagram
computers connected::computers connected
utp cables::utp cables
twisted pair::twisted pair
pair cables::pair cables
rj-45 connectors::rj-45 connectors
physical diagram::physical diagram
extended star::extended star
star connection::star connection
hybrid topology::hybrid topology
cable running::cable running
important topology::important topology
ring topology::ring topology
closed loop::closed loop
first node::first node
node passes::node passes
ring ring::ring ring
ring connections::ring connections
past offices::past offices
connector cables::connector cables
wrong side::wrong side
important reason::important reason
broken ring::broken ring
single ring::single ring
fault tolerance::fault tolerance
good reason::good reason
wide area::wide area
telephone exchanges::telephone exchanges
fiber optics::fiber optics
optics cable::optics cable
equal access::equal access
good thing::good thing
data travels::data travels
double ring::double ring
common type::common type
token ring::token ring
ring token::ring token
ieee standard::ieee standard
standard number::standard number
destination data::destination data
transmitting device::transmitting device
empty token::empty token
token passed::token passed
data packet::data packet
final user::final user
destination node::destination node
original sender::original sender
data packets::data packets
packets travel::packets travel
great speed::great speed
synchronous operation::synchronous operation
great speeds::great speeds
find faults::find faults
rectify faults::rectify faults
ordinary cable::ordinary cable
entire ring::entire ring
smaller rings::smaller rings
rings exist::rings exist
exist nowadays::exist nowadays
common topology::common topology
lan technologies::lan technologies
token passing::token passing
synchronized access::synchronized access
shared communication::shared communication
communication medium::communication medium
medium bits::medium bits
bits pass::bits pass
transmitter past::transmitter past
destination hardware::destination hardware
attached computer::attached computer
small technicality::small technicality
sender holding::sender holding
holding token::holding token
token transmits::token transmits
transmits bits::transmits bits
frames computer::frames computer
token passes::token passes
high speed::high speed
destination passes::destination passes
sender receives::sender receives
transmission computer::transmission computer
computer transmits::computer transmits
transmits token::transmits token
computer ready::computer ready
originally part::originally part
lan technology::lan technology
ring devices::ring devices
dominant lan::dominant lan
fddi lived::fddi lived
specific advantage::specific advantage
optic cables::optic cables
cables multi::cables multi
multi mode::multi mode
mode fibers::mode fibers
single mode::single mode
send data::send data
nowadays fddi::nowadays fddi
fddi technology::fddi technology
basic reason::basic reason
inherent fault::inherent fault
tolerance capability::tolerance capability
fault tolerant::fault tolerant
tolerant ring::tolerant ring
ring technology::ring technology
full form::full form
fiber distributed::fiber distributed
distributed data::distributed data
data interconnect::data interconnect
transmits data::transmits data
concentric rings::concentric rings
fault occurs::fault occurs
rings stars::rings stars
fddi switches::fddi switches
switches form::switches form
tree-like structure::tree-like structure
older networks::older networks
older segments::older segments
hybrid kind::hybrid kind
star bus::star bus
star ring::star ring
ring star::ring star
multi-station access::multi-station access
access unit::access unit
full mesh::full mesh
complete mesh::complete mesh
alternative paths::alternative paths
diagram shows::diagram shows
direct path::direct path
indirect paths::indirect paths
links breaks::links breaks
arrangement takes::arrangement takes
takes lot::takes lot
partial mesh::partial mesh
taking care::taking care
passing protocol::passing protocol
interconnect lans::interconnect lans
wan links::wan links
wan link::wan link
wan service::wan service
service providers::service providers
unavailable due::unavailable due
node failure::node failure
link failure::link failure
improves fault::improves fault
increased cost::increased cost
cost installation::cost installation
disadvantages rings::disadvantages rings
rings ease::rings ease
ease synchronization::ease synchronization
cable breaks::cable breaks
breaks star::breaks star
cable bus::cable bus
bus requires::bus requires
fewer cables::fewer cables
reliable bus::reliable bus
fashion extended::fashion extended
area networks::area networks
mesh topologies::mesh topologies
logical topologies::logical topologies
examples suppose::examples suppose
cable ducts::cable ducts
ducts running::ducts running
similar manner::similar manner
central place::central place
topology suppose::topology suppose
cables coming::cables coming
physical duct::physical duct
actual connection::actual connection
data access::data access
transmits packets::transmits packets
revealing cables::revealing cables
cables emerging::cables emerging
network box::network box
connection people::connection people
actual physical::actual physical
network boxes::network boxes
topology min::topology min
min place::min place
cable installation::cable installation
installation network::installation network
network connections::network connections
drill holes::drill holes
first thing::first thing
logical ring::logical ring
cost benefit::cost benefit
greenfield kind::greenfield kind
stable thing::stable thing
topology kind::topology kind
bandwidth capacity::bandwidth capacity
problems ease::problems ease
finding fault::finding fault
important factor::important factor
central cabling::central cabling
cabling plan::cabling plan
easy fault::easy fault
fault finding::fault finding
lecture good::lecture good
users share::users share
total bandwidth::total bandwidth
frequency range::frequency range
valuable resource::valuable resource
transmission services::transmission services
leased lines::leased lines
lines packet::lines packet
packet switched::packet switched
switched networks::switched networks
complex proposition::complex proposition
maximum amount::maximum amount
communication multiplexing::communication multiplexing
compression techniques::compression techniques
techniques save::techniques save
data capacity::data capacity
line increases::line increases
data devices::data devices
modest amount::modest amount
aggregated requirements::aggregated requirements
substantial bandwidth::substantial bandwidth
current technique::current technique
include frequency::include frequency
frequency division::frequency division
wavelength division::wavelength division
code division::code division
physical link::physical link
link .on::link .on
sender receiver::sender receiver
receiver pairs::receiver pairs
direct point::direct point
point connection::point connection
.first problem::.first problem
large amount::large amount
large number::large number
computer side::computer side
older approach::older approach
multi drop::multi drop
drop line::drop line
host polls::host polls
polls machine::polls machine
total communications::total communications
communications load::communications load
multiplexer approach::multiplexer approach
device data::device data
out link::out link
link carries::link carries
carries multiple::carries multiple
multiple channels::multiple channels
noise present::noise present
digital signals::digital signals
resilient compared::resilient compared
analog signals::analog signals
correct errors::correct errors
error checking::error checking
checking information::checking information
sending groups::sending groups
extra byte::extra byte
odd parity::odd parity
receiver end::receiver end
sending station::sending station
odd .in::odd .in
primitive kind::primitive kind
sophisticated error::sophisticated error
checking methods::checking methods
methods employed::methods employed
.sujoy ghosh::.sujoy ghosh
ghosh indian::ghosh indian
indian institute::indian institute
technology i.i.t::technology i.i.t
i.i.t kharagpur::i.i.t kharagpur
kharagpur lecture::kharagpur lecture
physical medium::physical medium
last lecture::last lecture
protocol stacks::protocol stacks
osi protocol::osi protocol
protocol stack::protocol stack
cpi pre::cpi pre
pre reference::pre reference
reference stack::reference stack
bottom-most layer::bottom-most layer
general characteristics::general characteristics
specific media::specific media
analog signal::analog signal
digital signal::digital signal
important consideration::important consideration
bandwidth bandwidth::bandwidth bandwidth
carry information::carry information
total capacity::total capacity
specific portion::specific portion
direct communication::direct communication
control purpose::control purpose
specific purpose::specific purpose
inherent capacity::inherent capacity
left-hand side::left-hand side
right-hand side::right-hand side
values shown::values shown
sin values::sin values
harmonics means::harmonics means
pure sin::pure sin
sin wave::sin wave
wave form::wave form
analog verses::analog verses
signals digital::signals digital
basic advantages::basic advantages
error prone::error prone
limited extent::limited extent
extent errors::extent errors
signal distortion::signal distortion
niche areas::niche areas
noise affects::noise affects
original signal::original signal
similar kind::similar kind
distorted signal::distorted signal
digital communication::digital communication
greatest advantage::greatest advantage
signal levels::signal levels
transmit bits::transmit bits
nyquist limit::nyquist limit
maximum bits::maximum bits
level modulation::level modulation
hard limit::hard limit
damaged signals::damaged signals
original shape::original shape
noise superimposed::noise superimposed
error-checking information::error-checking information
sophisticated error-checking::sophisticated error-checking
error-checking methods::error-checking methods
sophisticated coding::sophisticated coding
coding technique::coding technique
digital transmission::digital transmission
analog transmission::analog transmission
sensitive information::sensitive information
bank transaction::bank transaction
credit card::credit card
card number::card number
bank account::bank account
original numbers::original numbers
current stream::current stream
important application::important application
transmission compression::transmission compression
compress information::compress information
lossy compression::lossy compression
non-lossy compression::non-lossy compression
techniques lossy::techniques lossy
compression technique::compression technique
digital photograph::digital photograph
high resolution::high resolution
trained persons::trained persons
loss compression::loss compression
loss-less compression::loss-less compression
positive voltage::positive voltage
vice versa::vice versa
high voltage::high voltage
low voltage::low voltage
electrical signal::electrical signal
signal traveling::signal traveling
simplest wave::simplest wave
encode data::encode data
digital form::digital form
current state::current state
preferred analog::preferred analog
analog data::analog data
digital voice::digital voice
boosts noise::boosts noise
digital case::digital case
digital data::digital data
signal carries::signal carries
clean analog::clean analog
home computer::home computer
telephone connection::telephone connection
telephone line::telephone line
analog medium::analog medium
data ride::data ride
modem pairs::modem pairs
telephone exchange::telephone exchange
telephony system::telephony system
purely digital::purely digital
digital information::digital information
analog domain::analog domain
amplitude shift::amplitude shift
shift keying::shift keying
binary numbers::binary numbers
carrier waves::carrier waves
voice grade::voice grade
grade lines::grade lines
optical fiber::optical fiber
low amplitude::low amplitude
high amplitude::high amplitude
amplitude analog::amplitude analog
optical domain::optical domain
electrical domain::electrical domain
so-called frequency::so-called frequency
frequency shift::frequency shift
binary digits::binary digits
high-frequency radio::high-frequency radio
so-called phase::so-called phase
phase shift::phase shift
carrier wave::carrier wave
kilo bits::kilo bits
grade line::grade line
simple phase::simple phase
complex phase::complex phase
higher data::higher data
data rates::data rates
rates nowadays::rates nowadays
combine phase::combine phase
multilevel signaling::multilevel signaling
signal represents::signal represents
simple technique::simple technique
current level::current level
simplest kind::simplest kind
bit rate::bit rate
baud rate::baud rate
simplest case::simplest case
digital encoding::digital encoding
analog information::analog information
common case::common case
telephone switches::telephone switches
trunk exchanges::trunk exchanges
core network::core network
telephone system::telephone system
real world::real world
error correction::error correction
core telephone::core telephone
analog fashion::analog fashion
nearest exchange::nearest exchange
analog voice::analog voice
voice signal::voice signal
voice give::voice give
voice data::voice data
good quality::good quality
first so-called::first so-called
so-called gold::so-called gold
gold quality::gold quality
high fidelity::high fidelity
fidelity kind::fidelity kind
practical purposes::practical purposes
khz bandwidth::khz bandwidth
nyquist rate::nyquist rate
back nyquist::back nyquist
maximum frequency::maximum frequency
original analog::original analog
sample values::sample values
small amplitude::small amplitude
large amplitude::large amplitude
highest level::highest level
fundamental unit::fundamental unit
telephone people::telephone people
first network::first network
kbps happened::kbps happened
voice channel::voice channel
voice channels::voice channels
mbps capacity::mbps capacity
network depending::network depending
basic unit::basic unit
non return::non return
so-called nrz::so-called nrz
nrz encoding::nrz encoding
voltage levels::voltage levels
negative voltage::negative voltage
voltage equals::voltage equals
flip flops::flip flops
level voltage::level voltage
means non::means non
constant voltage::constant voltage
transition represents::transition represents
bit pattern::bit pattern
voltage pattern::voltage pattern
large train::large train
constant train::constant train
original data::original data
constant level::constant level
level signal::level signal
worst case::worst case
wrong fashion::wrong fashion
nrz code::nrz code
bit ends::bit ends
receiver results::receiver results
bit phase::bit phase
phase encoding::phase encoding
receiver clocks::receiver clocks
close synchronization::close synchronization
nice property::nice property
predictable bit::predictable bit
bit transition::bit transition
differential manchesters::differential manchesters
manchester encoding::manchester encoding
high transition::high transition
transition means::transition means
low transition::low transition
differential manchester::differential manchester
midbit transmission::midbit transmission
clock synchronization::clock synchronization
synchronization purposes::synchronization purposes
bit period::bit period
transition transition::transition transition
clocking purpose::clocking purpose
ring networks::ring networks
encoding techniques::encoding techniques
bit rates::bit rates
signals change::signals change
analog encoding::analog encoding
important area::important area
raw form::raw form
higher frequency::higher frequency
carrying voice::carrying voice
close vicinity::close vicinity
radio signal::radio signal
high frequency::high frequency
high-frequency so-called::high-frequency so-called
so-called carrier::so-called carrier
higher bandwidth::higher bandwidth
so-called modulation::so-called modulation
amplitude modulation::amplitude modulation
frequency modulation::frequency modulation
phase modulation::phase modulation
digital signaling::digital signaling
state transition::state transition
inherent trouble::inherent trouble
physical media::physical media
transmission medium::transmission medium
optic cable::optic cable
basic properties::basic properties
signal propagates::signal propagates
final signal::final signal
signal strength::signal strength
distance grows::distance grows
grows signals::grows signals
large distance::large distance
short wave::short wave
technical problems::technical problems
signal propagation::signal propagation
propagation point::propagation point
leakage currents::leakage currents
fundamental property::fundamental property
optical medium::optical medium
light pulse::light pulse
major effects::major effects
adjacent bits::adjacent bits
make recognition::make recognition
square wave::square wave
wave kind::wave kind
sign waves::sign waves
frequencies change::frequencies change
medium differently::medium differently
relative strengths::relative strengths
receiving end::receiving end
square shape::square shape
thermal energy::thermal energy
inherent noise::inherent noise
random signals::random signals
static discharge::static discharge
lightning strikes::lightning strikes
washing machine::washing machine
things add::things add
general noise::general noise
signal back::signal back
high signal-to-noise::high signal-to-noise
signal-to-noise ratio::signal-to-noise ratio
ratio signal::ratio signal
strength divided::strength divided
average noise::average noise
noise strength::noise strength
snr falls::snr falls
noise floor::noise floor
meaningful communication::meaningful communication
carried out::carried out
strong signal-to-noise::strong signal-to-noise
long distance::long distance
acceptable signal-to-noise::acceptable signal-to-noise
means energy::means energy
wire adds::wire adds
important point::important point
strong interference::strong interference
cable termination::cable termination
so-called cross::so-called cross
cross talk::cross talk
termination end::termination end
wired kind::wired kind
network infrastructure::network infrastructure
multiple wires::multiple wires
nearby wires::nearby wires
analog lines::analog lines
require modems::require modems
modems modem::modems modem
modem stands::modem stands
digital computer::digital computer
analog phone::analog phone
phone system::phone system
card inserted::card inserted
serial port::serial port
analog system::analog system
interesting field::interesting field
remember computer::remember computer
network nodes::network nodes
communication lines::communication lines
common networks::common networks
lecture lecture::lecture lecture
general impairments::general impairments
copper cable::copper cable
twisted pairs::twisted pairs
important cables::important cables
simple electromagnetic::simple electromagnetic
electromagnetic radiation::electromagnetic radiation
lan lan::lan lan
meter means::meter means
computer connected::computer connected
table connected::table connected
connected side::connected side
cable cat::cable cat
landline phones::landline phones
computer networking::computer networking
local telephone::local telephone
digital ports::digital ports
lan atm::lan atm
fddi ring::fddi ring
ring kind::ring kind
personal area::personal area
bigger network::bigger network
metropolitan area::metropolitan area
small towns::small towns
ballpark figure::ballpark figure
figure man::figure man
ten kilometers::ten kilometers
twenty kilometers::twenty kilometers
base band::base band
telephone lines::telephone lines
telephone linesi::telephone linesi
linesi told::linesi told
fiber fiber::fiber fiber
fiber means::fiber means
broad band::broad band
cable modem::cable modem
long ethernet::long ethernet
dsl digital::dsl digital
digital subscriber::digital subscriber
subscriber lines::subscriber lines
individual users.i::individual users.i
entire town::entire town
individual residence::individual residence
residence involves::residence involves
involves cost::involves cost
small building::small building
taking utp::taking utp
individual house::individual house
electromagnetic disturbance::electromagnetic disturbance
similar technology::similar technology
technology atm::technology atm
internet protocol::internet protocol
dwdm dense::dwdm dense
dense wavelength::dense wavelength
leo geo::leo geo
geo stands::geo stands
geostationary satellite::geostationary satellite
short form::short form
low art::low art
art orbiting::art orbiting
orbiting satellite::orbiting satellite
satellite computer::satellite computer
ghosh dept::ghosh dept
computer science::computer science
engineering i.i.t::engineering i.i.t
day today::day today
fiber optic::fiber optic
bigger networks::bigger networks
man man::man man
lines utp::lines utp
means fiber::means fiber
broadband coaxial::broadband coaxial
long-reach ethernet::long-reach ethernet
means ethernet::means ethernet
individual user::individual user
access users::access users
long distances::long distances
wan bandwidth::wan bandwidth
cost involved::cost involved
recent times::recent times
times lot::times lot
bandwidth problem::bandwidth problem
bandwidth remains::bandwidth remains
remains costly::remains costly
cable specifications::cable specifications
utp cable::utp cable
cables specification::cables specification
stretch things::stretch things
times depending::times depending
operating circumstances::operating circumstances
standard telephone::standard telephone
telephone cable::telephone cable
specific scientific::specific scientific
scientific number::scientific number
connecting cat::connecting cat
standard ansi::standard ansi
eia standard::eia standard
standard ways::standard ways
wires inside::wires inside
wire stands::wire stands
testing cables::testing cables
cables cat::cables cat
higher speed::higher speed
mbps connection::mbps connection
enhanced version::enhanced version
small distance::small distance
simple cat::simple cat
people thought::people thought
short period::short period
copper infrastructure::copper infrastructure
specification people::specification people
mbps today::mbps today
mbps saving::mbps saving
higher upfront::higher upfront
upfront cost::upfront cost
cost today::cost today
testing parameters::testing parameters
technical part::technical part
part return::part return
return loss::return loss
reflected energy::reflected energy
energy caused::energy caused
impedance mismatch::impedance mismatch
cabling system::cabling system
signal coupling::signal coupling
neighboring pair::neighboring pair
pair measured::pair measured
received signal::received signal
signal level::signal level
testing copper::testing copper
copper cables::copper cables
put fiber::put fiber
good idea::good idea
passive networking::passive networking
networking infrastructure::networking infrastructure
band coaxial::band coaxial
shielded cable::shielded cable
copper cord::copper cord
cord surrounded::cord surrounded
insulating material::insulating material
braided outer::braided outer
outer conductor::outer conductor
protective outer::protective outer
outer covering::outer covering
considerably thicker::considerably thicker
so-called thick::so-called thick
cable operator::cable operator
operator puts::operator puts
computer communications::computer communications
discussing man::discussing man
important issues::important issues
individual subscriber::individual subscriber
reached lot::reached lot
people started::people started
cable operators::cable operators
network communication::network communication
special kinds::special kinds
broadband cable::broadband cable
cable infrastructure::cable infrastructure
computer communication::computer communication
signal carrying::signal carrying
carrying data::carrying data
data traffic::data traffic
traffic older::traffic older
older cables::older cables
cables carry::cables carry
newer cables::newer cables
higher frequencies::higher frequencies
regular intervals::regular intervals
one-way amplifiers::one-way amplifiers
operators wanted::operators wanted
central location::central location
reach people::reach people
two-way amplifier::two-way amplifier
small technicalities::small technicalities
two-way amplification::two-way amplification
dual cable::dual cable
cable systems::cable systems
split systems::split systems
inbound traffic::inbound traffic
outbound traffic::outbound traffic
mid-split system::mid-split system
data communication::data communication
network traffic::network traffic
average user::average user
network nowadays::network nowadays
large files::large files
bandwidth requirement::bandwidth requirement
upstream bandwidth::upstream bandwidth
downstream bandwidth::downstream bandwidth
important kind::important kind
optical fibers::optical fibers
transparent silica::transparent silica
silica glass::silica glass
glass slab::glass slab
kilometers thick::kilometers thick
strict standards::strict standards
moderate dimensions::moderate dimensions
total internal::total internal
internal reflection::internal reflection
ordinary light::ordinary light
multimode fiber::multimode fiber
smaller dimensions::smaller dimensions
fiber acts::fiber acts
wave guide::wave guide
single-mode fiber::single-mode fiber
fiber multimode::fiber multimode
multimode fibers::multimode fibers
single-mode fibres::single-mode fibres
carrying signals::carrying signals
optical networking::optical networking
optical transmission::optical transmission
free space::free space
space means::space means
means suppose::means suppose
first obvious::first obvious
obvious problem::obvious problem
intervening air::intervening air
refractive index::refractive index
receiver altogether::receiver altogether
optic communication::optic communication
preferred people::preferred people
people prefer::people prefer
optic transmission::optic transmission
optical switching::optical switching
network level::network level
level functionalities::level functionalities
fiber capacity::fiber capacity
fantastic bandwidth::fantastic bandwidth
optic connection::optic connection
foreseable future::foreseable future
future requirements::future requirements
electromagnetic interference::electromagnetic interference
lightning strike::lightning strike
thin strand::thin strand
thing happened::thing happened
reason people::reason people
people favor::people favor
favor fiber::favor fiber
huge bandwidth::huge bandwidth
single piece::single piece
sending data::sending data
light carry::light carry
optic channel::optic channel
higher kind::higher kind
bandwidth lucent::bandwidth lucent
coarse wavelength::coarse wavelength
today varies::today varies
ultra dense::ultra dense
quick history::quick history
guided wave::guided wave
wave optics::wave optics
low loss::low loss
loss fibers::loss fibers
made long-distance::made long-distance
semi conductor::semi conductor
conductor laser::conductor laser
laser diode::laser diode
optical signals::optical signals
dot fiber::dot fiber
fiber amplifier::fiber amplifier
multiplexing system::multiplexing system
system started::system started
switching systems::switching systems
tremendous potential::tremendous potential
fad jacket::fad jacket
productive jacket::productive jacket
jacket made::jacket made
glass fiber::glass fiber
glass inside::glass inside
individual fibers::individual fibers
cross section::cross section
core in-between::core in-between
side ways::side ways
wide angle::wide angle
higher refractive::higher refractive
lower refractive::lower refractive
fiber bends::fiber bends
small bends::small bends
bending radius::bending radius
fiber cables::fiber cables
glass fibers::glass fibers
fiber socket::fiber socket
cut ends::cut ends
connecting fibers::connecting fibers
glass material::glass material
light sources::light sources
semiconductor lasers::semiconductor lasers
light emitting::light emitting
emitting diodes::emitting diodes
out lasers::out lasers
simple leds::simple leds
non-coherent lights::non-coherent lights
semi-conductor laser::semi-conductor laser
coherent light::coherent light
non-coherent light::non-coherent light
data rate::data rate
low fiber::low fiber
fiber type::fiber type
mode fibres::mode fibres
means lasers::means lasers
mode fiber::mode fiber
long-distance cables::long-distance cables
mode types::mode types
carry laser::carry laser
long life::long life
proper care::proper care
temperature sensitivity::temperature sensitivity
semiconductor laser::semiconductor laser
life source::life source
temperature led::temperature led
low cost::low cost
fiber remember::fiber remember
electrical transmission::electrical transmission
copper medium::copper medium
last class::last class
longer distance::longer distance
wave shape::wave shape
rayleigh scattering::rayleigh scattering
mie scattering::mie scattering
cylindrical structure::cylindrical structure
non uniform::non uniform
distorted fashion::distorted fashion
famous figure::famous figure
light signal::light signal
quiet high::quiet high
high distance::high distance
repeated kind::repeated kind
thing cheaper::thing cheaper
carry data::carry data
nanometer window::nanometer window
data transmission::data transmission
high frequencies::high frequencies
frequencies involved::frequencies involved
theoretical capacity::theoretical capacity
optoelectronic devices::optoelectronic devices
optic signal::optic signal
distance depending::distance depending
repeater function::repeater function
incoming signal::incoming signal
repeaters repeaters::repeaters repeaters
make corrections::make corrections
interesting phenomenon::interesting phenomenon
signals traveling::signals traveling
optical line::optical line
line transmitter::line transmitter
electronic domain::electronic domain
fresh source::fresh source
strong wave::strong wave
bandwidth limitations::bandwidth limitations
erbium doped::erbium doped
doped fiber::doped fiber
fiber amplifiers::fiber amplifiers
excited states::excited states
nanometer light::nanometer light
small quantity::small quantity
nanometer laser::nanometer laser
give amplification::give amplification
ordinary fiber::ordinary fiber
pump laser::pump laser
erbium atoms::erbium atoms
excited state::excited state
signal photon::signal photon
ground state::ground state
amplified signal::amplified signal
simplified version::simplified version
doped amplification::doped amplification
basic idea::basic idea
idea remains::idea remains
chromatic dispersion::chromatic dispersion
mode dispersion::mode dispersion
dispersion wave::dispersion wave
wave shaping::wave shaping
wave forms::wave forms
waves shaped::waves shaped
dispersion characteristics::dispersion characteristics
distance distortion::distance distortion
reverse fiber::reverse fiber
growing field::growing field
power surges::power surges
power failures::power failures
corrosive chemicals::corrosive chemicals
two-way communication::two-way communication
putting fiber::putting fiber
feverish pitch::feverish pitch
hall means::hall means
long hall::long hall
telecom company::telecom company
communications companies::communications companies
access side::access side
individual users::individual users
ways fibers::ways fibers
ultimate goal::ultimate goal
passive optical::passive optical
passive sort::passive sort
optical network::optical network
important physical::important physical
transmission methods::transmission methods
wired connections::wired connections
connections moving::connections moving
wired connection::wired connection
wireless connection::wireless connection
connection results::connection results
physical connection::physical connection
great advantage::great advantage
wireless fashion::wireless fashion
remain connected::remain connected
entire electromagnetic::entire electromagnetic
electromagnetic spectrum::electromagnetic spectrum
low end::low end
visible light::visible light
terrestrial microwave::terrestrial microwave
low frequency::low frequency
medium frequency::medium frequency
transmitting data::transmitting data
transmitted narrow::transmitted narrow
narrow band::narrow band
frequency bands::frequency bands
wide band::wide band
avoid communication::avoid communication
communication jams::communication jams
hide detection::hide detection
wireless lan::wireless lan
lan standard::lan standard
radio transmission::radio transmission
directional antenna::directional antenna
low frequencies::low frequencies
power falls::power falls
frequencies waves::frequencies waves
radio wave::radio wave
cover vlf::cover vlf
ground high-frequency::ground high-frequency
high-frequency waves::high-frequency waves
short-wave range::short-wave range
wave radio::wave radio
wireless communication::wireless communication
selective kind::selective kind
irritating thing::irritating thing
multipath fading::multipath fading
bad signal::bad signal
mobile phones::mobile phones
microwave transmission::microwave transmission
narrowly focused::narrowly focused
microwave towers::microwave towers
focused beam::focused beam
signal altogether::signal altogether
altogether beams::altogether beams
millimeter waves::millimeter waves
high end::high end
short-range communication::short-range communication
strictly directional::strictly directional
solid objects::solid objects
mobile phone::mobile phone
short-range connection::short-range connection
handheld device::handheld device
geostationary satellites::geostationary satellites
earth orbiting::earth orbiting
orbiting satellites::orbiting satellites
prof sujoy::prof sujoy
simplest condition::simplest condition
multiple signals::multiple signals
band width::band width
require modest::require modest
sum total::sum total
substantial band::substantial band
technique accomplish::technique accomplish
includes frequency::includes frequency
multiplexing wavelength::multiplexing wavelength
side depending::side depending
receiver pair::receiver pair
entire bandwidth::entire bandwidth
entire channel::entire channel
small burst::small burst
computers networks::computers networks
technology iit::technology iit
iit kharagpur::iit kharagpur
transmission service::transmission service
leased line::leased line
packet switching::packet switching
switching networks::switching networks
current techniques::current techniques
link in-between::link in-between
direct point-to-point::direct point-to-point
point-to-point connection::point-to-point connection
first problem::first problem
multi-drop line::multi-drop line
polls machines::polls machines
simple approaches::simple approaches
time-division multiplexing::time-division multiplexing
common approach::common approach
frequency spectrum::frequency spectrum
logical channels::logical channels
physical channel::physical channel
exclusive access::exclusive access
fdm sends::fdm sends
sends signals::sends signals
distinct frequency::distinct frequency
frequency ranges::frequency ranges
electromagnetic field::electromagnetic field
large range::large range
so-called radio::so-called radio
radio frequencies::radio frequencies
frequencies constitute::frequencies constitute
important part::important part
small channels::small channels
receiver side::receiver side
radio side::radio side
providers give::providers give
premise connected::premise connected
multiple video::multiple video
video channels::video channels
question imagine::question imagine
stringing wire::stringing wire
hundred cables::hundred cables
carrier frequency::carrier frequency
carrier frequencies::carrier frequencies
guard bands::guard bands
guard band::guard band
radio channel::radio channel
middle frequency::middle frequency
radio station::radio station
first station::first station
medium exceeds::medium exceeds
required bandwidth::required bandwidth
analog signaling::analog signaling
transmit signals::transmit signals
signals broadcast::signals broadcast
broadcast radio::broadcast radio
cable television::cable television
cellular phone::cellular phone
multiplexing amps::multiplexing amps
usa nowadays::usa nowadays
cellular technology::cellular technology
complex multiplexing::complex multiplexing
multiplexing techniques::multiplexing techniques
non-overlapping frequency::non-overlapping frequency
multiplexer accepts::multiplexer accepts
accepts inputs::accepts inputs
assigns frequencies::assigns frequencies
high-speed communications::high-speed communications
communications line::communications line
fat range::fat range
communication line::communication line
high-speed line::high-speed line
multiplexed signals::multiplexed signals
involves analog::involves analog
suppose user::suppose user
similarly channel::similarly channel
frequency band::frequency band
frequency channel::frequency channel
user hangs::user hangs
radio spectrum::radio spectrum
extending information::extending information
frequency versus::frequency versus
first channel::first channel
so-called guard::so-called guard
bps line::bps line
bps sub-channels::bps sub-channels
bands in-between::bands in-between
full capacity::full capacity
signals fdm::signals fdm
carry analog::carry analog
operating frequencies::operating frequencies
optical range::optical range
wavelengths means::wavelengths means
doing wavelength::doing wavelength
doing frequency::doing frequency
great potential::great potential
slight percentage::slight percentage
percentage diviation::percentage diviation
operating frequency::operating frequency
large bandwidth::large bandwidth
frequencies fibers::frequencies fibers
energy bands::energy bands
diffraction grating::diffraction grating
grating prism::grating prism
prism combined::prism combined
long distant::long distant
distant link::distant link
high reliability::high reliability
high capacity::high capacity
interesting properties::interesting properties
white light::white light
prism varies::prism varies
light source::light source
fiber spectrum::fiber spectrum
power versus::power versus
delivering power::delivering power
multiplexing multiplexes::multiplexing multiplexes
multiplexes multiple::multiplexes multiple
multiple data::multiple data
data streams::data streams
single fiber::single fiber
optic line::optic line
wavelength lasers::wavelength lasers
optical communication::optical communication
communication domain::communication domain
signal carried::signal carried
interesting thing::interesting thing
fiber system::fiber system
dwdm channel::dwdm channel
finding ways::finding ways
dense fashion::dense fashion
cheaper alternative::cheaper alternative
cheaper version::cheaper version
spectrum multiplexer::spectrum multiplexer
cheaper alternatives::cheaper alternatives
important multiplexing::important multiplexing
multiplexing technique::multiplexing technique
service provider::service provider
provider side::provider side
short duration::short duration
round-robin fashion::round-robin fashion
original user::original user
basic forms::basic forms
simpler scheme::simpler scheme
statistical multiplexing::statistical multiplexing
multiplexing scheme::multiplexing scheme
previous diagram::previous diagram
doing tdm::doing tdm
entire frequency::entire frequency
first burst::first burst
multiplexing saves::multiplexing saves
saves money::saves money
telephone call::telephone call
receiver number::receiver number
synchronous division::synchronous division
cable frequency::cable frequency
tdm splits::tdm splits
cable usage::cable usage
pcm signal::pcm signal
actual practice::actual practice
signals discussion::signals discussion
nyquist theorem::nyquist theorem
kilo samples::kilo samples
capturing voice::capturing voice
analog value::analog value
bit digital::bit digital
pulse coded::pulse coded
coded modulation::coded modulation
basic rate::basic rate
higher level::higher level
level channel::level channel
higher lever::higher lever
lever channels::lever channels
wide standards::wide standards
signals carrying::signals carrying
transmission media::transmission media
media exceeds::media exceeds
exceeds data::exceeds data
tdm system::tdm system
previous epoch::previous epoch
exceed data::exceed data
frame means::frame means
bytes put::bytes put
slow device::slow device
lower number::lower number
high-speed device::high-speed device
receiving side::receiving side
round robin::round robin
robin fashion::robin fashion
normal scheme::normal scheme
demultiplexing side::demultiplexing side
attached devices::attached devices
isdn telephone::isdn telephone
common examples::common examples
device generates::device generates
generates data::generates data
faster rate::faster rate
incoming data::incoming data
data stream::data stream
incoming stream::incoming stream
multiplexed stream::multiplexed stream
dummy data::dummy data
multiplexing schemes::multiplexing schemes
hybrid scheme::hybrid scheme
pure fdm::pure fdm
hybrid multiplexing::hybrid multiplexing
multiplexing systems::multiplexing systems
cell phone::cell phone
phone communication::phone communication
band multiple::band multiple
reschedule link::reschedule link
packet basis::packet basis
link remember::link remember
demultiplexer side::demultiplexer side
simple vanilla::simple vanilla
vanilla case::vanilla case
fancy kind::fancy kind
efficient manner::efficient manner
address inside::address inside
means inside::means inside
destination address::destination address
effective rate::effective rate
receiving data::receiving data
data data::data data
user sees::user sees
terminal identification::terminal identification
destination identification::destination identification
require storage::require storage
multiplexer end::multiplexer end
incoming packets::incoming packets
strict round::strict round
transmission channel::transmission channel
receiver address::receiver address
proper receiver::proper receiver
buffer packets::buffer packets
packet queue::packet queue
vanilla kind::vanilla kind
fancy schemes::fancy schemes
high-priority queue::high-priority queue
senders decide::senders decide
data loss::data loss
statistical multiplexer::statistical multiplexer
multiplexer transmits::multiplexer transmits
active work::active work
work stations::work stations
work station::work station
packet lengths::packet lengths
size varies::size varies
data part::data part
interesting scheme::interesting scheme
multiple access::multiple access
specific convergence::specific convergence
access system::access system
system cdma::system cdma
sense call::sense call
cell phones::cell phones
wireless station::wireless station
mobile handsets::mobile handsets
base station::base station
discuss code::discuss code
division multiple::division multiple
good things::good things
simple means::simple means
signals tdm::signals tdm
multiplexing hierarchy::multiplexing hierarchy
telephone network::telephone network
small exchange::small exchange
small number::small number
std call::std call
trunk exchange::trunk exchange
finally reach::finally reach
local exchanges::local exchanges
big trunk::big trunk
tributaries flowing::tributaries flowing
small tributaries::small tributaries
fat channel::fat channel
multiplexing hierarchies::multiplexing hierarchies
synchronous digital::synchronous digital
digital hierarchy::digital hierarchy
efficient bandwidth::efficient bandwidth
specially data::specially data
data usage::data usage
quiescent period::quiescent period
ordinary tdm::ordinary tdm
control information::control information
varying sizes::varying sizes
stdm systems::stdm systems
varying size::varying size
size cells::size cells
fixed size::fixed size
low noise::low noise
noise sensitivity::noise sensitivity
domain suppose::domain suppose
electrical noise::electrical noise
electrical wire::electrical wire
higher capacity::higher capacity
wasted bandwidth::wasted bandwidth
small band::small band
limited frequency::limited frequency
stdm takes::stdm takes
takes care::takes care
stdm wdm::stdm wdm
developing technology::developing technology
wdm cost::wdm cost
techniques today::techniques today
telecom network::telecom network
telecommunication network::telecommunication network
people talking::people talking
area data::area data
traffic today::traffic today
lecture preview::lecture preview
lecture computers::lecture computers
telecom networks::telecom networks
earliest network::earliest network
area communication::area communication
exclusive data::exclusive data
data networks::data networks
alexander graham::alexander graham
graham bell::graham bell
bell developed::bell developed
first telephone::first telephone
telephone instruments::telephone instruments
instruments connected::instruments connected
principle forward::principle forward
good long::good long
long term::long term
term strategy::term strategy
veritable jungle::veritable jungle
subscriber end::subscriber end
wires coming::wires coming
central switching::central switching
switching office::switching office
telephone subscribers::telephone subscribers
parallel network::parallel network
excellent history::excellent history
telecom people::telecom people
voice calls::voice calls
packet kind::packet kind
voice traffic::voice traffic
standard analog::standard analog
analog telephony::analog telephony
telephony signals::telephony signals
dsl modem::dsl modem
frequency digital::frequency digital
digital broadband::digital broadband
broadband signals::broadband signals
ordinary analog::ordinary analog
central office::central office
office end::office end
signal passes::signal passes
local loop::local loop
loop management::loop management
management system::management system
subscriber line::subscriber line
line access::line access
access multiplexer::access multiplexer
broadband digital::broadband digital
coordinates traffic::coordinates traffic
loop lines::loop lines
service kind::service kind
computer::computer
networks::networks
prof::prof
sujoy::sujoy
ghosh::ghosh
lecture::lecture
network::network
topology::topology
good::good
day::day
discuss::discuss
reference::reference
quick::quick
recap::recap
learnt::learnt
last::last
basically::basically
number::number
nodes::nodes
connected::connected
communication::communication
links::links
kind::kind
call::call
graph::graph
representing::representing
structure::structure
talk::talk
implication::implication
communicate::communicate
general::general
feasible::feasible
one-to-one::one-to-one
pair::pair
node::node
formed::formed
manner::manner
subject::subject
matter::matter
discussion::discussion
today::today
represented::represented
represent::represent
devices::devices
switches::switches
routers::routers
modes::modes
broadcast::broadcast
point::point
first::first
lan::lan
topologies::topologies
local::local
area::area
star::star
ring::ring
bus::bus
simple::simple
based::based
shared::shared
link::link
point-to-point::point-to-point
specifically::specifically
communicating::communicating
short::short
send::send
message::message
ignore::ignore
private::private
sense::sense
copy::copy
purpose::purpose
distributed::distributed
protocol::protocol
decide::decide
communications::communications
collide::collide
medium::medium
pairs::pairs
garbled::garbled
clear::clear
signal::signal
require::require
simplest::simplest
thing::thing
single::single
cable::cable
connects::connects
computers::computers
hanging::hanging
synchronize::synchronize
transmit::transmit
copper::copper
picture::picture
simply::simply
capture::capture
maintained::maintained
segment::segment
end::end
terminator::terminator
happen::happen
sends::sends
reflected::reflected
properly::properly
terminated::terminated
unwanted::unwanted
noise::noise
coaxial::coaxial
two::two
types::types
cables::cables
traditionally::traditionally
thin::thin
thick::thick
extra::extra
stations::stations
added::added
daisy::daisy
chain::chain
technology::technology
sort::sort
outdated::outdated
moment::moment
lans::lans
people::people
moving::moving
out::out
main::main
reason::reason
connection::connection
loose::loose
problem::problem
reasons::reasons
obsolete::obsolete
days::days
machines::machines
sharing::sharing
standard::standard
ieee::ieee
eliminate::eliminate
replace::replace
ethernet::ethernet
10base2::10base2
stands::stands
mbps::mbps
speed::speed
maximum::maximum
range::range
length::length
meters::meters
connections::connections
four::four
repeaters::repeaters
total::total
long::long
travels::travels
line::line
weak::weak
regenerate::regenerate
repeater::repeater
incoming::incoming
amplify::amplify
stronger::stronger
handle::handle
version::version
10base5::10base5
megabits::megabits
backbones::backbones
limited::limited
net::net
advantages::advantages
disadvantages::disadvantages
inexpensive::inexpensive
easy::easy
add::add
punch::punch
station::station
means::means
amount::amount
works::works
small::small
longer::longer
recommended::recommended
parts::parts
fashion::fashion
unreliable::unreliable
reliable::reliable
disadvantage::disadvantage
attached::attached
difficult::difficult
isolate::isolate
problems::problems
slows::slows
response::response
rates::rates
direct::direct
dedicated::dedicated
channels::channels
connect::connect
forms::forms
mesh::mesh
complete::complete
flexibility::flexibility
hardware::hardware
packet::packet
formats::formats
security::security
privacy::privacy
interconnect::interconnect
nc2::nc2
approximately::approximately
equal::equal
involved::involved
increasing::increasing
expensive::expensive
previous::previous
high::high
suppose::suppose
connecting::connecting
issue::issue
ports::ports
provide::provide
alternative::alternative
coming::coming
illustrated::illustrated
buildings::buildings
enormous::enormous
side::side
running::running
lot::lot
reduce::reduce
give::give
idea::idea
directly::directly
necessarily::necessarily
share::share
ways::ways
doing::doing
multiplexing::multiplexing
takes::takes
turns::turns
orderly::orderly
division::division
include::include
technique::technique
synchronizing::synchronizing
channel::channel
wait::wait
turn::turn
34-17.18::34-17.18
common::common
central::central
hub::hub
centre::centre
wheel::wheel
stage::stage
mention::mention
physical::physical
logical::logical
made::made
advantage::advantage
converting::converting
previously::previously
practical::practical
utility::utility
case::case
disconnected::disconnected
bring::bring
centrally::centrally
locate::locate
find::find
failures::failures
bit::bit
maintains::maintains
important::important
diagram::diagram
idealized::idealized
written::written
rj-45::rj-45
connector::connector
ubiquitous::ubiquitous
telephones::telephones
utp::utp
unshielded::unshielded
twisted::twisted
easier::easier
cheaper::cheaper
connectors::connectors
sides::sides
extended::extended
stars::stars
hubs::hubs
switch::switch
50-21::50-21
hybrid::hybrid
part::part
leaving::leaving
closed::closed
loop::loop
passes::passes
data::data
hopping::hopping
reaches::reaches
destination::destination
surely::surely
reach::reach
practice::practice
run::run
past::past
offices::offices
sockets::sockets
rings::rings
direction::direction
wrong::wrong
put::put
putting::putting
failure::failure
possibility::possibility
wrap::wrap
physically::physically
broken::broken
breakage::breakage
break::break
fail::fail
things::things
fault::fault
tolerance::tolerance
wide::wide
telephone::telephone
exchanges::exchanges
fiber::fiber
optics::optics
talking::talking
cut::cut
place::place
trick::trick
shown::shown
summary::summary
characteristics::characteristics
beginning::beginning
access::access
media::media
double::double
device::device
start::start
transmitting::transmitting
type::type
token::token
extracted::extracted
acknowledgement::acknowledgement
receipt::receipt
back::back
removed::removed
empty::empty
passed::passed
make::make
final::final
user::user
identification::identification
bunch::bunch
meant::meant
extract::extract
original::original
sender::sender
received::received
remove::remove
circulating::circulating
.as::.as
packets::packets
travel::travel
great::great
synchronous::synchronous
operation::operation
remember::remember
actions::actions
killing::killing
synchronized::synchronized
synchronization::synchronization
speeds::speeds
collisions::collisions
faults::faults
rectify::rectify
terminators::terminators
required::required
ordinary::ordinary
requires::requires
couple::couple
breakdowns::breakdowns
entire::entire
smaller::smaller
exist::exist
nowadays::nowadays
concerned::concerned
fact::fact
technologies::technologies
passing::passing
treated::treated
bits::bits
pass::pass
transmitter::transmitter
copied::copied
designed::designed
commission::commission
technicality::technicality
interface::interface
function::function
independently::independently
nice::nice
shut::shut
affected::affected
holding::holding
transmits::transmits
frames::frames
circulate::circulate
makes::makes
receives::receives
frame::frame
work::work
waits::waits
transmission::transmission
ready::ready
originally::originally
fell::fell
disuse::disuse
costly::costly
dominant::dominant
fddi::fddi
lived::lived
due::due
specific::specific
optic::optic
multi::multi
mode::mode
fibers::fibers
fairly::fairly
comparable::comparable
level::level
aging::aging
sound::sound
proposed::proposed
basic::basic
inherent::inherent
capability::capability
tolerant::tolerant
extensively::extensively
wan::wan
full::full
form::form
order::order
magnitude::magnitude
concentric::concentric
occurs::occurs
automatically::automatically
disturbed::disturbed
emanates::emanates
configured::configured
tree-like::tree-like
older::older
updated::updated
replaced::replaced
segments::segments
combines::combines
mau::mau
multi-station::multi-station
unit::unit
study::study
discussed::discussed
earlier::earlier
paths::paths
shows::shows
path::path
indirect::indirect
source::source
breaks::breaks
arrangement::arrangement
partial::partial
dropped::dropped
taking::taking
care::care
redundancy::redundancy
evolve::evolve
method::method
sensing::sensing
correcting::correcting
complicated::complicated
places::places
wans::wans
users::users
naturally::naturally
expect::expect
grade::grade
service::service
providers::providers
unavailable::unavailable
traffic::traffic
pros::pros
cons::cons
improves::improves
carry::carry
increased::increased
cost::cost
installation::installation
difficulty::difficulty
management::management
troubleshooting::troubleshooting
ease::ease
disabled::disabled
manage::manage
robust::robust
fewer::fewer
gravitating::gravitating
emerging::emerging
21-46::21-46
examples::examples
ducts::ducts
similar::similar
essentially::essentially
similarly::similarly
duct::duct
actual::actual
revealing::revealing
piece::piece
box::box
replaces::replaces
depending::depending
choice::choice
affect::affect
dictate::dictate
depend::depend
boxes::boxes
design::design
carefully::carefully
change::change
designing::designing
min::min
correct::correct
determine::determine
protocols::protocols
spots::spots
drill::drill
holes::holes
building::building
factors::factors
account::account
deciding::deciding
kinds::kinds
factor::factor
benefit::benefit
greenfield::greenfield
situation::situation
significant::significant
question::question
scalability::scalability
choked::choked
bandwidth::bandwidth
join::join
happening::happening
stable::stable
organization::organization
years::years
scale::scale
capacity::capacity
install::install
finding::finding
class::class
cabling::cabling
plan::plan
.there::.there
standards::standards
structured::structured
maintenance::maintenance
preview::preview
signals::signals
interfere::interfere
.for::.for
multiple::multiple
divided::divided
portion::portion
frequency::frequency
valuable::valuable
resource::resource
facilitate::facilitate
senders::senders
receivers.that::receivers.that
chief::chief
services::services
leased::leased
lines::lines
switched::switched
laying::laying
complex::complex
proposition::proposition
lay::lay
utilize::utilize
compression::compression
techniques::techniques
save::save
money::money
business::business
increases::increases
effective::effective
company::company
.most::.most
individually::individually
modest::modest
aggregated::aggregated
requirements::requirements
occupy::occupy
substantial::substantial
current::current
accomplish::accomplish
wavelength::wavelength
code::code
scheme::scheme
multiplexer::multiplexer
inputs::inputs
.so::.so
mixed::mixed
.on::.on
separated::separated
recipients::recipients
left::left
receivers::receivers
receiver::receiver
utilizing::utilizing
.first::.first
large::large
wiring::wiring
floors::floors
hundreds::hundreds
.that::.that
bottleneck::bottleneck
approach::approach
drop::drop
host::host
polls::polls
machine::machine
load::load
greater::greater
rate::rate
multiplexed::multiplexed
carries::carries
information::information
restored::restored
quantum::quantum
present::present
.if::.if
lose::lose
distortion::distortion
loss::loss
digital::digital
resilient::resilient
compared::compared
analog::analog
errors::errors
bytes::bytes
error::error
checking::checking
retransmission::retransmission
detected::detected
sending::sending
groups::groups
byte::byte
odd::odd
parity::parity
flipped::flipped
happened::happened
supposed::supposed
adding::adding
.in::.in
request::request
retransmit::retransmit
primitive::primitive
sophisticated::sophisticated
methods::methods
employed::employed
.sujoy::.sujoy
indian::indian
institute::institute
i.i.t::i.i.t
kharagpur::kharagpur
stacks::stacks
osi::osi
stack::stack
detail::detail
cpi::cpi
pre::pre
model::model
bottom-most::bottom-most
layer::layer
top::top
shape::shape
represents::represents
series::series
zeros::zeros
stream::stream
value::value
consideration::consideration
divide::divide
control::control
intermittently::intermittently
linked::linked
left-hand::left-hand
right::right
bargraph::bargraph
representation::representation
right-hand::right-hand
sin::sin
values::values
sum::sum
harmonics::harmonics
constant::constant
figure::figure
pure::pure
wave::wave
harmonic::harmonic
complexity::complexity
comparison::comparison
verses::verses
prone::prone
rectified::rectified
easily::easily
extent::extent
corrected::corrected
limitations::limitations
preferred::preferred
rules::rules
niche::niche
areas::areas
statement::statement
error-prone::error-prone
affects::affects
hard::hard
deduce::deduce
superimposed::superimposed
distorted::distorted
square::square
shaped::shaped
eliminated::eliminated
greatest::greatest
levels::levels
terms::terms
nyquist::nyquist
limit::limit
log2::log2
modulation::modulation
bps::bps
kbps::kbps
higher::higher
fast::fast
52-10::52-10
regeneration::regeneration
slightly::slightly
damaged::damaged
states::states
grossly::grossly
weaker::weaker
strength::strength
deformed::deformed
voltage::voltage
volts::volts
result::result
electronics::electronics
restore::restore
spike::spike
restoration::restoration
fault-tolerant::fault-tolerant
resistant::resistant
error-checking::error-checking
correction::correction
adopted::adopted
coding::coding
36-14::36-14
encrypted::encrypted
sensitive::sensitive
e-banking::e-banking
vogue::vogue
bank::bank
transaction::transaction
e-commerce::e-commerce
buy::buy
online::online
pay::pay
credit::credit
card::card
password::password
snoop::snoop
in-between::in-between
secrets::secrets
set::set
numbers::numbers
acceptable::acceptable
encrypt::encrypt
snoops::snoops
finds::finds
encryption::encryption
application::application
compress::compress
decompress::decompress
circuit::circuit
lighter::lighter
lossy::lossy
non-lossy::non-lossy
photograph::photograph
resolution::resolution
image::image
trained::trained
persons::persons
missing::missing
serve::serve
loss-less::loss-less
space::space
decompression::decompression
ends::ends
overhead::overhead
encode::encode
digitally::digitally
presence::presence
absence::absence
positive::positive
binary::binary
vice::vice
versa::versa
interpret::interpret
low::low
assuming::assuming
electrical::electrical
traveling::traveling
light::light
state::state
forced::forced
amplifiers::amplifiers
voice::voice
trouble::trouble
boosts::boosts
amplified::amplified
done::done
correctness::correctness
32-19::32-19
content::content
recover::recover
pattern::pattern
retransmits::retransmits
recovers::recovers
generates::generates
clean::clean
internet::internet
home::home
modem::modem
ride::ride
exchange::exchange
converted::converted
backbone::backbone
core::core
telephony::telephony
system::system
purely::purely
domain::domain
amplitude::amplitude
shift::shift
keying::keying
amplitudes::amplitudes
carrier::carrier
waves::waves
efficient::efficient
optical::optical
i.e::i.e
transmitted::transmitted
so-called::so-called
binaries::binaries
frequencies::frequencies
digits::digits
susceptible::susceptible
commonly::commonly
high-frequency::high-frequency
radio::radio
encoding::encoding
phase::phase
fsk::fsk
psk::psk
raised::raised
kilo::kilo
achieve::achieve
combined::combined
combine::combine
modems::modems
multilevel::multilevel
signaling::signaling
baud::baud
times::times
coin::coin
told::told
heart::heart
trunk::trunk
real::real
world::world
move::move
adopt::adopt
robustness::robustness
resiliency::resiliency
handsets::handsets
carried::carried
nearest::nearest
codecs::codecs
coders::coders
decoders::decoders
convert::convert
calculation::calculation
khz::khz
quality::quality
gold::gold
fidelity::fidelity
purposes::purposes
noticeable::noticeable
digitize::digitize
sample::sample
needed::needed
fully::fully
reconstruct::reconstruct
samples::samples
points::points
distinguish::distinguish
assumption::assumption
highest::highest
admissible::admissible
capturing::capturing
volume::volume
fundamental::fundamental
built::built
planned::planned
telecommunications::telecommunications
encoded::encoded
non::non
return::return
nrz::nrz
typically::typically
negative::negative
equals::equals
returns::returns
flip::flip
flops::flops
duration::duration
remains::remains
transition::transition
boundaries::boundaries
consecutively::consecutively
variant::variant
nrzi::nrzi
invert::invert
encodings::encodings
train::train
clocks::clocks
drift::drift
worst::worst
starts::starts
string::string
timing::timing
results::results
remain::remain
close::close
property::property
predictable::predictable
manchester::manchester
differential::differential
manchesters::manchesters
47-34::47-34
middle::middle
ethernets::ethernets
midbit::midbit
clock::clock
period::period
clocking::clocking
popular::popular
raw::raw
carrying::carrying
atmosphere::atmosphere
excepting::excepting
vicinity::vicinity
locations::locations
translated::translated
music::music
understand::understand
changed::changed
telling::telling
lower::lower
throwing::throwing
wire::wire
inevitably::inevitably
play::play
effects::effects
perfect::perfect
properties::properties
systems::systems
spite::spite
efforts::efforts
correctly::correctly
propagates::propagates
recognize::recognize
attributed::attributed
attenuation::attenuation
distance::distance
finally::finally
grows::grows
weakening::weakening
dependent::dependent
depends::depends
technical::technical
making::making
propagation::propagation
view::view
leakage::leakage
currents::currents
leak::leak
pulse::pulse
major::major
shapes::shapes
adjacent::adjacent
overlap::overlap
recognition::recognition
impossible::impossible
talked::talked
looked::looked
sign::sign
differently::differently
attenuated::attenuated
relative::relative
strengths::strengths
receiving::receiving
pick::pick
thermal::thermal
energy::energy
random::random
spikes::spikes
occur::occur
car::car
starting::starting
static::static
discharge::discharge
lightning::lightning
strikes::strikes
motor::motor
washing::washing
catch::catch
sharp::sharp
signal-to-noise::signal-to-noise
ratio::ratio
average::average
snr::snr
falls::falls
increase::increase
touches::touches
floor::floor
meaningful::meaningful
strong::strong
regenerators::regenerators
filter::filter
noises::noises
push::push
span::span
maintain::maintain
interference::interference
adds::adds
intermittent::intermittent
diagnose::diagnose
termination::termination
parallel::parallel
linkage::linkage
cross::cross
pronounced::pronounced
terminate::terminate
leave::leave
introduced::introduced
wired::wired
infrastructure::infrastructure
careful::careful
wires::wires
bundle::bundle
radiates::radiates
nearby::nearby
bad::bad
terminations::terminations
unwound::unwound
mentioned::mentioned
demodulation::demodulation
phone::phone
installed::installed
internally::internally
inserted::inserted
motherboard::motherboard
serial::serial
port::port
field::field
interesting::interesting
details::details
basics::basics
absolutely::absolutely
all-important::all-important
this.in::this.in
deployed::deployed
impairments::impairments
networking::networking
mediawhich::mediawhich
classes::classes
shielded::shielded
electromagnetic::electromagnetic
radiation::radiation
ranges::ranges
infrared::infrared
microwave::microwave
satellite::satellite
vary::vary
meter::meter
kilometer::kilometer
strictly::strictly
size::size
siding::siding
table::table
wireless::wireless
note::note
varieties::varieties
categories::categories
cat::cat
cat3::cat3
5cable::5cable
.you::.you
landline::landline
phones::phones
prefer::prefer
onwards::onwards
pbx::pbx
atm::atm
personal::personal
varying::varying
body::body
pan::pan
spectrum::spectrum
bigger::bigger
man::man
metropolitan::metropolitan
campus::campus
city::city
towns::towns
ballpark::ballpark
ten::ten
kilometers::kilometers
twenty::twenty
base::base
band::band
broadband::broadband
linesi::linesi
broad::broad
dsl::dsl
subscriber::subscriber
individual::individual
users.i::users.i
town::town
residence::residence
reaching::reaching
involves::involves
room::room
house::house
disturbance::disturbance
build::build
extreme::extreme
stretch::stretch
globe::globe
involve::involve
sonet::sonet
sdh::sdh
dwdm::dwdm
dense::dense
geo::geo
leo::leo
geostationary::geostationary
art::art
orbiting::orbiting
dept::dept
science::science
engineering::engineering
interested::interested
on.you::on.you
category::category
wearing::wearing
purview::purview
extend::extend
long-reach::long-reach
distances::distances
imagine::imagine
thousands::thousands
recent::recent
laid::laid
internationally::internationally
specifications::specifications
specification::specification
mhz::mhz
figures::figures
normal::normal
operating::operating
circumstances::circumstances
scientific::scientific
ansi::ansi
tia::tia
eia::eia
inside::inside
tested::tested
tsb::tsb
testing::testing
expected::expected
enhanced::enhanced
operate::operate
costlier::costlier
started::started
thought::thought
slow::slow
comparatively::comparatively
demand::demand
grown::grown
thousand-fold::thousand-fold
planning::planning
mind::mind
giving::giving
upgrade::upgrade
saving::saving
upfront::upfront
parameters::parameters
measure::measure
caused::caused
impedance::impedance
mismatch::mismatch
test::test
elfext::elfext
defined::defined
coupling::coupling
neighboring::neighboring
measured::measured
passive::passive
meaning::meaning
perform::perform
cord::cord
surrounded::surrounded
insulating::insulating
material::material
braided::braided
outer::outer
conductor::conductor
protective::protective
covering::covering
considerably::considerably
thicker::thicker
knowledge::knowledge
presented::presented
hundred::hundred
desktop::desktop
operator::operator
puts::puts
discussing::discussing
issues::issues
reached::reached
homes::homes
thinking::thinking
operators::operators
special::special
cities::cities
newer::newer
regular::regular
intervals::intervals
one-way::one-way
wanted::wanted
broadcasting::broadcasting
location::location
two-way::two-way
amplifier::amplifier
technicalities::technicalities
neighbors::neighbors
amplification::amplification
dual::dual
trees::trees
rooted::rooted
head-end::head-end
equipments::equipments
split::split
inbound::inbound
rest::rest
outbound::outbound
mid-split::mid-split
asymmetry::asymmetry
found::found
surfing::surfing
query::query
flows::flows
downloading::downloading
files::files
images::images
songs::songs
movies::movies
requirement::requirement
upstream::upstream
downstream::downstream
glass::glass
transparent::transparent
silica::silica
tens::tens
slab::slab
quiet::quiet
transparency::transparency
strict::strict
drawn::drawn
moderate::moderate
dimensions::dimensions
restricted::restricted
internal::internal
reflection::reflection
multimode::multimode
nanometers::nanometers
acts::acts
guide::guide
lasers::lasers
single-mode::single-mode
fibres::fibres
free::free
laser::laser
straight::straight
obvious::obvious
sight::sight
hindrance::hindrance
complications::complications
intervening::intervening
air::air
hot::hot
refractive::refractive
index::index
bend::bend
mirage::mirage
desert::desert
miss::miss
altogether::altogether
switching::switching
functionalities::functionalities
topic::topic
research::research
promising::promising
huge::huge
terabits::terabits
fantastic::fantastic
endpoints::endpoints
foreseable::foreseable
future::future
met::met
immune::immune
strike::strike
strand::strand
surge::surge
burn::burn
equipment::equipment
favor::favor
theoretical::theoretical
asked::asked
ultimately::ultimately
dictated::dictated
limitation::limitation
suddenly::suddenly
interest::interest
wavelengths::wavelengths
wdm::wdm
lucent::lucent
demonstrated::demonstrated
lambda::lambda
gbps::gbps
gigabits::gigabits
coarse::coarse
sothe::sothe
varies::varies
working::working
ultra::ultra
history::history
discovered::discovered
mid-60s::mid-60s
guided::guided
production::production
presently::presently
long-distance::long-distance
invention::invention
semi::semi
diode::diode
70s::70s
80s::80s
bother::bother
mid-80s::mid-80s
late::late
breakthrough::breakthrough
optically::optically
amplifying::amplifying
edfa::edfa
rbm::rbm
dot::dot
mid::mid-
90s::90s
21st::21st
century::century
components::components
developed::developed
tremendous::tremendous
potential::potential
cross-section::cross-section
fad::fad
jacket::jacket
productive::productive
plastic::plastic
rubber::rubber
cladding::cladding
typical::typical
cores::cores
section::section
refracts::refracts
impinges::impinges
wall::wall
angle::angle
incidence::incidence
difference::difference
bends::bends
follow::follow
sharply::sharply
bending::bending
radius::radius
curvature::curvature
input::input
plugging::plugging
socket::socket
clamping::clamping
splice::splice
mechanically::mechanically
sleeve::sleeve
fuse::fuse
solid::solid
totally::totally
homogenous::homogenous
junction::junction
splicing::splicing
referred::referred
sources::sources
semiconductor::semiconductor
emitting::emitting
diodes::diodes
leds::leds
non-coherent::non-coherent
lights::lights
semi-conductor::semi-conductor
coherent::coherent
led::led
cover::cover
tend::tend
life::life
lifetime::lifetime
proper::proper
temperature::temperature
sensitivity::sensitivity
minor::minor
closer::closer
losses::losses
weaken::weaken
weakened::weakened
thickness::thickness
true::true
highly::highly
phenomena::phenomena
rayleigh::rayleigh
scattering::scattering
slight::slight
scattered::scattered
mie::mie
imperfection::imperfection
cylindrical::cylindrical
uniform::uniform
arrive::arrive
famous::famous
plot::plot
windows::windows
repeated::repeated
action::action
nanometer::nanometer
window::window
calculate::calculate
potentially::potentially
optoelectronic::optoelectronic
gates::gates
corrections::corrections
phenomenon::phenomenon
repeat::repeat
strengthened::strengthened
olts::olts
olt::olt
electronic::electronic
fresh::fresh
leg::leg
journey::journey
erbium::erbium
doped::doped
excited::excited
quantity::quantity
million::million
pumped::pumped
pump::pump
fed::fed
atoms::atoms
region::region
photon::photon
induces::induces
ground::ground
simplified::simplified
dispersion::dispersion
chromatic::chromatic
polarization::polarization
shaping::shaping
combination::combination
solitons::solitons
specially::specially
match::match
soliton::soliton
counteracted::counteracted
reverse::reverse
up-coming::up-coming
growing::growing
opposed::opposed
power::power
surges::surges
corrosive::corrosive
chemicals::chemicals
simplex::simplex
strands::strands
feverish::feverish
pitch::pitch
hall::hall
sgas::sgas
telecom::telecom
companies::companies
metro::metro
ultimate::ultimate
goal::goal
neighborhood::neighborhood
concept::concept
keeping::keeping
open::open
splitter::splitter
splits::splits
pon::pon
ability::ability
mobility::mobility
visible::visible
maritime::maritime
terrestrial::terrestrial
names::names
super::super
extremely::extremely
coax::coax
narrow::narrow
watts::NNP
bands::bands
jump::jump
avoid::avoid
jams::jams
hide::hide
detection::detection
bluetooth::bluetooth
generate::generate
omni::omni
directional::directional
antenna::antenna
directions::directions
walls::walls
bounce::bounce
obstacles::obstacles
vlf::vlf
bounced::bounced
ionosphere::ionosphere
earth::earth
short-wave::short-wave
listen::listen
usa::usa
repeatedly::repeatedly
selective::selective
irritating::irritating
multipath::multipath
fading::fading
cancel::cancel
encounter::encounter
mobile::mobile
narrowly::narrowly
focused::focused
moved::moved
tower::tower
towers::towers
alignment::alignment
beam::beam
aligned::aligned
beams::beams
delayed::delayed
sync::sync
millimeter::millimeter
short-range::short-range
directed::directed
cheap::cheap
don::don
objects::objects
controlling::controlling
handheld::handheld
satellites::satellites
sky::sky
lec::lec
faculty::faculty
shareing::shareing
condition::condition
garble::garble
width::width
includes::includes
fdm::fdm
tdm::tdm
stdm::stdm
statistical::statistical
quickly::quickly
periodically::periodically
burst::burst
iit::iit
saves::saves
cost-effective::cost-effective
address::address
multi-drop::multi-drop
i::-NONE-
approaches::approaches
time-division::time-division
exclusive::exclusive
distinct::distinct
oldest::oldest
constitute::constitute
tune::tune
premise::premise
apparently::apparently
video::video
stringing::stringing
modulated::modulated
guard::guard
principle::principle
non-overlapping::non-overlapping
assigned::assigned
separation::separation
exceeds::exceeds
television::television
amps::amps
cellular::cellular
country::country
assignment::assignment
accepts::accepts
assigns::assigns
high-speed::high-speed
adapt::adapt
fat::fat
words::words
demultiplexer::demultiplexer
separates::separates
separate::separate
hangs::hangs
mechanism::mechanism
extending::extending
versus::versus
overlapping::overlapping
sub-channels::sub-channels
utilized::utilized
summarize::summarize
dealing::dealing
applied::applied
percentage::percentage
diviation::diviation
compact::compact
pack::pack
diffraction::diffraction
grating::grating
prism::prism
distant::distant
reliability::reliability
demultiplexing::demultiplexing
white::white
colours::colours
simplicity::simplicity
delivering::delivering
multiplexes::multiplexes
streams::streams
denoting::denoting
improving::improving
packing::packing
scalable::scalable
recently::recently
cwdm::cwdm
widely::widely
spaced::spaced
costs::costs
alternatives::alternatives
telecommunication::telecommunication
provider::provider
accomplished::accomplished
dividing::dividing
disposal::disposal
round-robin::round-robin
exclusively::exclusively
asynchronous::asynchronous
simpler::simpler
slicing::slicing
quiescent::quiescent
schematic::schematic
allowing::allowing
terminal::terminal
sequence::sequence
slot::slot
usage::usage
slots::slots
pcm::pcm
hierarchy::hierarchy
theorem::theorem
8,000::8,000
coded::coded
distributing::distributing
distinction::distinction
64,000::64,000
grouped::grouped
lever::lever
accumulated::accumulated
epoch::epoch
buffer::buffer
accumulate::accumulate
exceed::exceed
slice::slice
blind::blind
round::round
robin::robin
weakness::weakness
agree::agree
isdn::isdn
faster::faster
insert::insert
dummy::dummy
schemes::schemes
allotted::allotted
cell::cell
accommodated::accommodated
fixed::fixed
reschedule::reschedule
basis::basis
interweaved::interweaved
decipher::decipher
addressed::addressed
scheduling::scheduling
vanilla::vanilla
fancy::fancy
utilizes::utilizes
relationship::relationship
tells::tells
calling::calling
bursting::bursting
periods::periods
utilization::utilization
dramatically::dramatically
inherently::inherently
bursts::bursts
stuff::stuff
processed::processed
sees::sees
storage::storage
land::land
hoping::hoping
store::store
forward::forward
queue::queue
memory::memory
stored::stored
contained::contained
contending::contending
high-priority::high-priority
paying::paying
queues::queues
possibilities::possibilities
theoretically::theoretically
filling::filling
overflow::overflow
congestion::congestion
active::active
wasted::wasted
creates::creates
identify::identify
included::included
addresses::addresses
lengths::lengths
destined::destined
blurred::blurred
converged::converged
diverges::diverges
convergence::convergence
cdma::cdma
slowly::slowly
guess::guess
lots::lots
std::std
converging::converging
big::big
tributaries::tributaries
flowing::flowing
hierarchies::hierarchies
implement::implement
bursty::bursty
wasting::wasting
sizes::sizes
cells::cells
writing::writing
separately::separately
permanently::permanently
developing::developing
earliest::earliest
evolution::evolution
54-55::54-55
alexander::alexander
graham::graham
bell::bell
instruments::instruments
subscribers::subscribers
unwieldy::unwieldy
term::term
strategy::strategy
veritable::veritable
jungle::jungle
office::office
switchboard::switchboard
46-56::46-56
lecturer::lecturer
excellent::excellent
rides::rides
session::session
story::story
process::process
routing::routing
calls::calls
00-57::00-57
end::end-
unlike::unlike
23-57::23-57
36-57::36-57
40-57::40-57
dslam::dslam
44-57::44-57
terminates::terminates
coordinates::coordinates
router::router
02-58::02-58
front::front
functions::functions
