software that controls::software that controls
controls the hardware::controls the hardware
due to microcode::due to microcode
programs that make::programs that make
make the hardware::make the hardware
set of programs::set of programs
programs that controls::programs that controls
controls a computer::controls a computer
computer some examples::computer some examples
examples of operating::examples of operating
controlling the computer::controlling the computer
computer involves software::computer involves software
differentiate kernel services::differentiate kernel services
operating system processes::operating system processes
system processes run::system processes run
processes run applications::processes run applications
libraries that perform::libraries that perform
perform standard services::perform standard services
services the kernel::services the kernel
supports the processes::supports the processes
processes by providing::processes by providing
providing a path::providing a path
devices the kernel::devices the kernel
responds to service::responds to service
processes and interrupts::processes and interrupts
devices the core::devices the core
program that functions::program that functions
functions in privileged::functions in privileged
reacting to interrupts::reacting to interrupts
interrupts from external::interrupts from external
requests and traps::requests and traps
traps from processes::traps from processes
computer it creates::computer it creates
creates and terminates::creates and terminates
processes and responds::processes and responds
request for service::request for service
service operating systems::service operating systems
systems are resource::systems are resource
managers the main::managers the main
resource is computer::resource is computer
form of processors::form of processors
operating system functions::operating system functions
implementing the user::implementing the user
hardware among users::hardware among users
users to share::users to share
users from interfering::users from interfering
resources among users::resources among users
recovering from errors::recovering from errors
accounting for resource::accounting for resource
facilitating parallel operations::facilitating parallel operations
data for secure::data for secure
secure and rapid::secure and rapid
handling network communications::handling network communications
network communications objectives::network communications objectives
objectives of operating::objectives of operating
operating systems modern::operating systems modern
systems modern operating::systems modern operating
modern operating systems::modern operating systems
major goals operating::major goals operating
goals operating systems::goals operating systems
systems generally accomplish::systems generally accomplish
accomplish these goals::accomplish these goals
goals by running::goals by running
processes in low::processes in low
privilege and providing::privilege and providing
providing service calls::providing service calls
calls that invoke::calls that invoke
invoke the operating::invoke the operating
operating system kernel::operating system kernel
kernel in high-privilege::kernel in high-privilege
details of hardware::details of hardware
hardware by creating::hardware by creating
abstraction an abstraction::abstraction an abstraction
abstraction is software::abstraction is software
software that hides::software that hides
hides lower level::hides lower level
lower level details::lower level details
set of higher-level::set of higher-level
functions an operating::functions an operating
operating system transforms::operating system transforms
transforms the physical::transforms the physical
world of devices::world of devices
result of abstractions::result of abstractions
reasons for abstraction::reasons for abstraction
needed to control::needed to control
control peripheral devices::control peripheral devices
standardized operating systems::standardized operating systems
operating systems provide::operating systems provide
systems provide subroutines::systems provide subroutines
subroutines called device::subroutines called device
drivers that perform::drivers that perform
operations on behalf::operations on behalf
behalf of programs::behalf of programs
operating system introduces::operating system introduces
introduces new functions::introduces new functions
abstracts the hardware::abstracts the hardware
hardware for instance::hardware for instance
introduces the file::introduces the file
deal with disks::deal with disks
transforms the computer::transforms the computer
hardware into multiple::hardware into multiple
multiple virtual computers::multiple virtual computers
program each program::program each program
process each process::process each process
views the hardware::views the hardware
lens of abstraction::lens of abstraction
system can enforce::system can enforce
security through abstraction::security through abstraction
resources to processes::resources to processes
operating system controls::operating system controls
controls how processes::controls how processes
provide a pleasant::provide a pleasant
pleasant and effective::pleasant and effective
effective user interface::effective user interface
interface the user::interface the user
integration the recent::integration the recent
increasingly integrated graphical::increasingly integrated graphical
integrated graphical user::integrated graphical user
graphical user interfaces::graphical user interfaces
interfaces that encompass::interfaces that encompass
encompass the activities::encompass the activities
activities of multiple::activities of multiple
processes on networks::processes on networks
networks of computers::networks of computers
view operating systems::view operating systems
points of views::points of views
manager and extended::manager and extended
extended machines form::extended machines form
machines form resource::machines form resource
form resource manager::form resource manager
resource manager point::resource manager point
point of view::point of view
operating systems manage::operating systems manage
extended machines point::extended machines point
provide a virtual::provide a virtual
machine to users::machine to users
structurally operating systems::structurally operating systems
hierarchy of layers::hierarchy of layers
virtual machine system::virtual machine system
model the basic::model the basic
concepts of operating::concepts of operating
systems are processes::systems are processes
history of operating::history of operating
systems historically operating::systems historically operating
historically operating systems::historically operating systems
idea to study::idea to study
study the history::study the history
run operating systems::run operating systems
systems have evolved::systems have evolved
number of distinct::number of distinct
phases or generations::phases or generations
generations which corresponds::generations which corresponds
generations the earliest::generations the earliest
earliest electronic digital::earliest electronic digital
electronic digital computers::electronic digital computers
operating systems machines::operating systems machines
primitive that programs::primitive that programs
entered one bit::entered one bit
rows of mechanical::rows of mechanical
languages were unknown::languages were unknown
systems were unheard::systems were unheard
routine had improved::routine had improved
introduction of punch::introduction of punch
cards the general::cards the general
general motors research::general motors research
motors research laboratories::motors research laboratories
research laboratories implemented::research laboratories implemented
implemented the first::implemented the first
first operating systems::first operating systems
systems in early::systems in early
ran one job::ran one job
single-stream batch processing::single-stream batch processing
batch processing systems::batch processing systems
systems because programs::systems because programs
programs and data::programs and data
data were submitted::data were submitted
submitted in groups::submitted in groups
groups or batches::groups or batches
generation the systems::generation the systems
computer s resources::computer s resources
resources by running::resources by running
running several jobs::running several jobs
operating systems designers::operating systems designers
systems designers developed::systems designers developed
developed the concept::developed the concept
concept of multiprogramming::concept of multiprogramming
processor is switched::processor is switched
switched from job::switched from job
job to job::job to job
job as needed::job as needed
advancing while keeping::advancing while keeping
keeping the peripheral::keeping the peripheral
current job paused::current job paused
paused to wait::paused to wait
operation to complete::operation to complete
cpu simply sat::cpu simply sat
simply sat idle::simply sat idle
finished the solution::finished the solution
problem that evolved::problem that evolved
job was waiting::job was waiting
cpu another major::cpu another major
feature in third-generation::feature in third-generation
third-generation operating system::third-generation operating system
technique called spooling::technique called spooling
simultaneous peripheral operations::simultaneous peripheral operations
operations on line::operations on line
low-speed device involved::low-speed device involved
outputs are written::outputs are written
programs can run::programs can run
run to completion::run to completion
note that spooling::note that spooling
thread being spun::thread being spun
unwound as needed::unwound as needed
needed another feature::needed another feature
generation was time-sharing::generation was time-sharing
variant of multiprogramming::variant of multiprogramming
user is present::user is present
present and interacting::present and interacting
system must respond::system must respond
quickly to user::quickly to user
productivity could suffer::productivity could suffer
suffer timesharing systems::suffer timesharing systems
systems were developed::systems were developed
developed to multiprogram::developed to multiprogram
multiprogram large number::multiprogram large number
number of simultaneous::number of simultaneous
simultaneous interactive users::simultaneous interactive users
interactive users fourth::interactive users fourth
users fourth generation::users fourth generation
development of lsi::development of lsi
large scale integration::large scale integration
operating system entered::operating system entered
workstation age microprocessor::workstation age microprocessor
age microprocessor technology::age microprocessor technology
microprocessor technology evolved::microprocessor technology evolved
build desktop computers::build desktop computers
computers as powerful::computers as powerful
1970s two operating::1970s two operating
two operating systems::two operating systems
systems have dominated::systems have dominated
dominated the personal::dominated the personal
personal computer scene::personal computer scene
written by microsoft::written by microsoft
large personal computers::large personal computers
cpu family system::cpu family system
family system components::family system components
structure many modern::structure many modern
operating systems share::operating systems share
goal of supporting::goal of supporting
types of system::types of system
system components process::system components process
components process management::components process management
management the operating::management the operating
operating system manages::operating system manages
manages many kinds::manages many kinds
kinds of activities::kinds of activities
ranging from user::ranging from user
programs to system::programs to system
programs like printer::programs like printer
activities is encapsulated::activities is encapsulated
process a process::process a process
includes the complete::includes the complete
complete execution context::complete execution context
important to note::important to note
program a process::program a process
program in execution::program in execution
system in regard::system in regard
regard to process::regard to process
creation and deletion::creation and deletion
deletion of user::deletion of user
user and system::user and system
processes * suspension::processes * suspension
suspension and resumption::suspension and resumption
resumption of processes::resumption of processes
mechanism for process::mechanism for process
mechanism for deadlock::mechanism for deadlock
deadlock handling main-memory::deadlock handling main-memory
handling main-memory management::handling main-memory management
main-memory management primary-memory::main-memory management primary-memory
primary-memory or main-memory::primary-memory or main-memory
array of words::array of words
words or bytes::words or bytes
bytes each word::bytes each word
word or byte::word or byte
main-memory provides storage::main-memory provides storage
memory the major::memory the major
operating in regard::operating in regard
regard to memory-management::regard to memory-management
part of memory::part of memory
decide which process::decide which process
process are loaded::process are loaded
loaded into memory::loaded into memory
memory when memory::memory when memory
allocate and deallocate::allocate and deallocate
deallocate memory space::deallocate memory space
space as needed::space as needed
needed file management::needed file management
management a file::management a file
collected of related::collected of related
related information defined::related information defined
computer can store::computer can store
provide long term::provide long term
long term storage::long term storage
storage some examples::storage some examples
examples of storage::examples of storage
media are magnetic::media are magnetic
disk and optical::disk and optical
properties like speed::properties like speed
data transfer rate::data transfer rate
rate and access::rate and access
methods a file::methods a file
systems normally organized::systems normally organized
organized into directories::organized into directories
directories to ease::directories to ease
main major activities::main major activities
regard to file::regard to file
deletion of files::deletion of files
deletion of directions::deletion of directions
support of primitives::support of primitives
primitives for manipulating::primitives for manipulating
files and directions::files and directions
mapping of files::mapping of files
files onto secondary::files onto secondary
files on stable::files on stable
stable storage media::stable storage media
media i system::media NNP system
i system management::NNP system management
management i subsystem::management NN subsystem
hides the peculiarities::hides the peculiarities
peculiarities of specific::peculiarities of specific
specific hardware devices::specific hardware devices
assigned secondary-storage management::assigned secondary-storage management
management generally speaking::management generally speaking
levels of storage::levels of storage
including primary storage::including primary storage
storage and cache::storage and cache
cache storage instructions::cache storage instructions
instructions and data::instructions and data
program because main::program because main
small to accommodate::small to accommodate
accommodate all data::accommodate all data
data and programs::data and programs
data are lost::data are lost
lost when power::lost when power
power is lost::power is lost
system must provide::system must provide
provide secondary storage::provide secondary storage
storage to back::storage to back
back up main::back up main
main memory secondary::main memory secondary
memory secondary storage::memory secondary storage
secondary storage consists::secondary storage consists
consists of tapes::consists of tapes
designed to hold::designed to hold
eventually be accessed::eventually be accessed
accessed in primary::accessed in primary
divided into bytes::divided into bytes
bytes or words::bytes or words
number of bytes::number of bytes
bytes each location::bytes each location
location in storage::location in storage
regard to secondary::regard to secondary
secondary storage management::secondary storage management
managing the free::managing the free
allocation of storage::allocation of storage
scheduling the requests::scheduling the requests
requests for memory::requests for memory
memory access networking::memory access networking
networking a distributed::networking a distributed
collection of processors::collection of processors
clock the processors::clock the processors
lines called network::lines called network
network the communication-network::network the communication-network
routing and connection::routing and connection
problems of contention::problems of contention
contention and security::contention and security
security protection system::security protection system
systems has multiple::systems has multiple
execution of multiple::execution of multiple
activities protection refers::activities protection refers
refers to mechanism::refers to mechanism
mechanism for controlling::mechanism for controlling
controlling the access::controlling the access
access of programs::access of programs
computer systems command::computer systems command
systems command interpreter::systems command interpreter
command interpreter system::command interpreter system
system a command::system a command
user the user::user the user
user gives commands::user gives commands
executed by operating::executed by operating
user specified command::user specified command
multiple command interpreters::multiple command interpreters
run in kernel::run in kernel
two main advantages::two main advantages
advantages to separating::advantages to separating
separating the command::separating the command
change the interface::change the interface
interface of command::interface of command
interpreter is separate::interpreter is separate
change the code::change the code
modify the interface::modify the interface
process to gain::process to gain
command interpreter separate::command interpreter separate
separate from kernel::separate from kernel
kernel operating systems::kernel operating systems
operating systems services::operating systems services
users program execution::users program execution
execution the purpose::execution the purpose
user to execute::user to execute
conveniently run programs::conveniently run programs
programs the user::programs the user
allocation or multitasking::allocation or multitasking
operating systems running::operating systems running
running a program::running a program
involves the allocating::involves the allocating
allocating and deallocating::allocating and deallocating
scheduling in case::scheduling in case
case of multiprocess::case of multiprocess
multiprocess these functions::multiprocess these functions
programs so user-level::programs so user-level
user to run::user to run
systems i operations::systems NNP operations
operations each program::operations each program
requires an input::requires an input
input and produces::input and produces
output this involves::output this involves
i the operating::NNP the operating
operating systems hides::operating systems hides
hides the user::hides the user
user the details::user the details
details of underlying::details of underlying
systems by providing::systems by providing
providing i makes::providing NNP makes
makes it convenient::makes it convenient
users to run::users to run
efficiently and protection::efficiently and protection
provided by user-level::provided by user-level
user-level programs file::user-level programs file
programs file system::programs file system
file system manipulation::file system manipulation
manipulation the output::manipulation the output
files or input::files or input
files the operating::files the operating
service the user::service the user
worry about secondary::worry about secondary
storage management user::storage management user
command for reading::command for reading
reading or writing::reading or writing
file and sees::file and sees
accomplished thus operating::accomplished thus operating
operating systems makes::operating systems makes
makes it easier::makes it easier
easier for user::easier for user
programs to accomplished::programs to accomplished
accomplished their task::accomplished their task
task this service::task this service
service involves secondary::service involves secondary
involves secondary storage::involves secondary storage
management the speed::management the speed
i that depends::NNP that depends
depends on secondary::depends on secondary
management is critical::management is critical
systems to manage::systems to manage
giving individual users::giving individual users
users the control::users the control
programs to provide::programs to provide
provide these services::provide these services
service s left::service s left
left with operating::left with operating
operating system communications::operating system communications
instances where processes::instances where processes
computer or running::computer or running
computers by providing::computers by providing
providing this service::providing this service
service the operating::service the operating
operating system relieves::operating system relieves
relieves the user::relieves the user
worry of passing::worry of passing
messages between processes::messages between processes
processes in case::processes in case
passed to processes::passed to processes
operating system error::operating system error
system error detection::system error detection
detection an error::detection an error
system to avoid::system to avoid
situation the operating::situation the operating
system constantly monitors::system constantly monitors
monitors the system::monitors the system
system for detecting::system for detecting
detecting the errors::detecting the errors
errors this relieves::errors this relieves
worry of errors::worry of errors
system and causing::system and causing
malfunctioning this service::malfunctioning this service
handled by user::handled by user
cases altering area::cases altering area
area of memory::area of memory
memory or deallocation::memory or deallocation
deallocation of memory::deallocation of memory
relinquishing the cpu::relinquishing the cpu
loop these tasks::loop these tasks
programs a user::programs a user
privileges can interfere::privileges can interfere
operating systems system::operating systems system
systems system calls::systems system calls
calls and system::calls and system
system programs system::system programs system
programs system calls::programs system calls
system calls provide::system calls provide
provide an interface::provide an interface
operating system system::operating system system
system system calls::system system calls
calls allow user-level::calls allow user-level
processes to request::processes to request
request some services::request some services
system which process::system which process
handling the trap::handling the trap
system will enter::system will enter
access to privileged::access to privileged
perform the desired::perform the desired
behalf of user-level::behalf of user-level
nature of operations::nature of operations
i a process::NNP a process
involves a system::involves a system
system call telling::system call telling
telling the operating::telling the operating
system to read::system to read
read or write::read or write
write particular area::write particular area
request is satisfied::request is satisfied
system system programs::system system programs
system programs provide::system programs provide
programs provide basic::programs provide basic
provide basic functioning::provide basic functioning
functioning to users::functioning to users
environment for program::environment for program
system calls layered::system calls layered
calls layered approach::calls layered approach
layered approach design::layered approach design
case the system::case the system
system is easier::system is easier
easier to debug::easier to debug
debug and modify::debug and modify
affect only limited::affect only limited
affecting that data::affecting that data
data are limited::data are limited
module or layer::module or layer
mechanisms and policies::mechanisms and policies
policies the policies::policies the policies
done for instance::done for instance
construct for ensuring::construct for ensuring
ensuring cpu protection::ensuring cpu protection
protection is mechanism::protection is mechanism
long the timer::long the timer
timer is set::timer is set
decision the separation::decision the separation
separation of mechanism::separation of mechanism
mechanism and policy::mechanism and policy
policy is important::policy is important
important to provide::important to provide
interface between mechanism::interface between mechanism
change of policy::change of policy
policy may affect::policy may affect
two is vague::two is vague
involve much deeper::involve much deeper
programmer the choice::programmer the choice
two provides flexibility::two provides flexibility
variety of ways::variety of ways
implement a variety::implement a variety
variety of policies::variety of policies
changing the policy::changing the policy
require the development::require the development
change in parameters::change in parameters
library of mechanisms::library of mechanisms
increase its efficiency::increase its efficiency
operating system::operating system
hardware useable::hardware useable
operating systems::operating systems
computer involves::computer involves
involves software::involves software
differentiate kernel::differentiate kernel
kernel services::kernel services
library services::library services
application-level services::application-level services
system processes::system processes
processes run::processes run
run applications::run applications
perform standard::perform standard
standard services::standard services
kernel supports::kernel supports
peripheral devices::peripheral devices
kernel responds::kernel responds
service calls::service calls
control program::control program
privileged state::privileged state
execution context::execution context
hardware instructions::hardware instructions
external devices::external devices
service requests::service requests
permanent resident::permanent resident
terminates processes::terminates processes
service operating::service operating
resource managers::resource managers
main resource::main resource
computer hardware::computer hardware
communication devices::communication devices
system functions::system functions
user interface::user interface
sharing hardware::sharing hardware
allowing users::allowing users
share data::share data
preventing users::preventing users
scheduling resources::scheduling resources
resource usage::resource usage
facilitating parallel::facilitating parallel
parallel operations::parallel operations
organizing data::organizing data
rapid access::rapid access
handling network::handling network
network communications::network communications
communications objectives::communications objectives
modern operating::modern operating
major goals::major goals
goals operating::goals operating
running processes::running processes
low privilege::low privilege
providing service::providing service
system kernel::system kernel
high-privilege state::high-privilege state
hide details::hide details
creating abstraction::creating abstraction
lower level::lower level
level details::level details
higher-level functions::higher-level functions
system transforms::system transforms
physical world::physical world
virtual world::virtual world
abstractions built::abstractions built
code needed::code needed
standardized operating::standardized operating
systems provide::systems provide
provide subroutines::provide subroutines
device drivers::device drivers
perform operations::perform operations
system introduces::system introduces
file abstraction::file abstraction
virtual computers::virtual computers
process views::process views
enforce security::enforce security
allocate resources::allocate resources
manage resources::manage resources
system controls::system controls
active agents::active agents
access resources::access resources
passive entities::passive entities
effective user::effective user
user interacts::user interacts
important components::important components
command interpreter::command interpreter
file system::file system
application integration::application integration
recent trend::recent trend
graphical user::graphical user
user interfaces::user interfaces
multiple processes::multiple processes
view operating::view operating
resource manager::resource manager
extended machines::extended machines
machines form::machines form
form resource::form resource
manager point::manager point
systems manage::systems manage
machines point::machines point
virtual machine::virtual machine
monolithic system::monolithic system
machine system::machine system
client-server model::client-server model
basic concepts::basic concepts
memory management::memory management
file systems::file systems
security history::security history
computer architecture::computer architecture
good idea::good idea
run operating::run operating
distinct phases::distinct phases
first generations::first generations
earliest electronic::earliest electronic
electronic digital::electronic digital
digital computers::digital computers
systems machines::systems machines
mechanical switches::mechanical switches
plug boards::plug boards
programming languages::programming languages
assembly languages::assembly languages
punch cards::punch cards
general motors::general motors
motors research::motors research
research laboratories::research laboratories
laboratories implemented::laboratories implemented
first operating::first operating
batch processing::batch processing
processing systems::processing systems
systems designers::systems designers
designers developed::designers developed
main memory::main memory
jobs advancing::jobs advancing
current job::current job
job paused::job paused
sat idle::sat idle
partition memory::partition memory
major feature::major feature
third-generation operating::third-generation operating
simultaneous peripheral::simultaneous peripheral
peripheral operations::peripheral operations
high-speed device::high-speed device
disk interposed::disk interposed
running program::running program
low-speed device::low-speed device
device involved::device involved
disk programs::disk programs
completion faster::completion faster
initiated sooner::initiated sooner
printed note::printed note
spooling technique::spooling technique
feature present::feature present
time-sharing technique::time-sharing technique
multiprogramming technique::multiprogramming technique
computer system::computer system
user requests::user requests
user productivity::user productivity
suffer timesharing::suffer timesharing
timesharing systems::timesharing systems
large number::large number
simultaneous interactive::simultaneous interactive
interactive users::interactive users
fourth generation::fourth generation
large scale::large scale
scale integration::scale integration
system entered::system entered
personal computer::personal computer
workstation age::workstation age
age microprocessor::age microprocessor
microprocessor technology::microprocessor technology
technology evolved::technology evolved
build desktop::build desktop
desktop computers::desktop computers
computer scene::computer scene
large personal::large personal
personal computers::personal computers
cpu family::cpu family
family system::family system
system components::system components
systems share::systems share
components process::components process
process management::process management
system manages::system manages
activities ranging::activities ranging
user programs::user programs
system programs::system programs
printer spooler::printer spooler
file server::file server
process includes::process includes
complete execution::complete execution
major activities::major activities
process synchronization::process synchronization
process communication::process communication
deadlock handling::deadlock handling
handling main-memory::handling main-memory
main-memory management::main-memory management
management primary-memory::management primary-memory
large array::large array
memory space::memory space
deallocate memory::deallocate memory
needed file::needed file
file management::file management
related information::related information
information defined::information defined
creator computer::creator computer
store files::store files
secondary storage::secondary storage
long term::long term
term storage::term storage
storage media::storage media
magnetic tape::magnetic tape
magnetic disk::magnetic disk
optical disk::optical disk
data transfer::data transfer
transfer rate::transfer rate
access methods::access methods
manipulating files::manipulating files
stable storage::stable storage
system management::system management
subsystem hides::subsystem hides
specific hardware::specific hardware
hardware devices::hardware devices
device driver::device driver
specific device::specific device
assigned secondary-storage::assigned secondary-storage
secondary-storage management::secondary-storage management
primary storage::primary storage
cache storage::cache storage
storage instructions::storage instructions
storage consists::storage consists
media designed::media designed
hold information::hold information
words consisting::words consisting
fixed number::fixed number
address space::address space
storage management::storage management
free space::free space
secondary-storage device::secondary-storage device
storage space::storage space
memory access::memory access
access networking::access networking
distributed systems::distributed systems
share memory::share memory
processors communicate::processors communicate
communication lines::communication lines
communication-network design::communication-network design
connection strategies::connection strategies
security protection::security protection
protection system::protection system
computer systems::computer systems
multiple users::multiple users
concurrent execution::concurrent execution
activities protection::activities protection
protection refers::protection refers
resources defined::resources defined
systems command::systems command
interpreter system::interpreter system
system calls::system calls
main function::main function
command command-interpreter::command command-interpreter
multiple command::multiple command
command interpreters::command interpreters
unix terminology::unix terminology
kernel mode::kernel mode
main advantages::main advantages
malicious process::malicious process
gain access::gain access
ugly scenario::ugly scenario
kernel operating::kernel operating
systems services::systems services
services provided::services provided
users program::users program
program execution::program execution
execute programs::execute programs
run programs::run programs
memory allocation::memory allocation
systems running::systems running
program involves::program involves
deallocating memory::deallocating memory
cpu scheduling::cpu scheduling
user-level programs::user-level programs
program requires::program requires
produces output::produces output
systems hides::systems hides
underlying hardware::underlying hardware
user sees::user sees
protection users::protection users
programs file::programs file
system manipulation::system manipulation
management user::management user
task accomplished::task accomplished
systems makes::systems makes
service involves::service involves
individual users::individual users
mentioned reasons::mentioned reasons
system communications::system communications
exchange information::exchange information
processes running::processes running
system relieves::system relieves
passing messages::passing messages
user program::user program
message transits::message transits
service interface::service interface
system error::system error
error detection::error detection
complete system::complete system
constantly monitors::constantly monitors
errors propagating::errors propagating
causing malfunctioning::causing malfunctioning
cases altering::cases altering
altering area::altering area
faulty process::faulty process
infinite loop::infinite loop
systems system::systems system
programs system::programs system
calls provide::calls provide
system system::system system
user-level processes::user-level processes
privileged instructions::privileged instructions
desired service::desired service
user-level process::user-level process
critical nature::critical nature
process involves::process involves
system call::system call
call telling::call telling
programs provide::programs provide
basic functioning::basic functioning
program development::program development
calls layered::calls layered
layered approach::layered approach
approach design::approach design
limited portions::limited portions
layers information::layers information
bugs affecting::bugs affecting
specific module::specific module
layer mechanisms::layer mechanisms
mechanism specifies::mechanism specifies
timer construct::timer construct
ensuring cpu::ensuring cpu
cpu protection::cpu protection
policy decision::policy decision
provide flexibility::provide flexibility
deeper change::deeper change
underlying implementation::underlying implementation
introduction::introduction
operating::operating
system::system
definition::definition
software::software
controls::controls
hardware::hardware
today::today
due::due
microcode::microcode
programs::programs
make::make
useable::useable
set::set
computer::computer
examples::examples
systems::systems
unix::unix
mach::mach
ms-dos::ms-dos
ms-windows::ms-windows
chicago::chicago
os::-NONE-
macos::macos
vms::vms
mvs::mvs
controlling::controlling
involves::involves
levels::levels
differentiate::differentiate
kernel::kernel
services::services
library::library
application-level::application-level
part::part
processes::processes
run::run
applications::applications
linked::linked
libraries::libraries
perform::perform
standard::standard
supports::supports
providing::providing
path::path
peripheral::peripheral
devices::devices
responds::responds
service::service
calls::calls
interrupts::interrupts
core::core
control::control
program::program
functions::functions
privileged::privileged
state::state
execution::execution
context::context
instructions::instructions
executed::executed
reacting::reacting
external::external
requests::requests
traps::traps
generally::generally
permanent::permanent
resident::resident
creates::creates
terminates::terminates
request::request
resource::resource
managers::managers
main::main
form::form
processors::processors
storage::storage
communication::communication
data::data
implementing::implementing
user::user
interface::interface
sharing::sharing
users::users
allowing::allowing
share::share
preventing::preventing
interfering::interfering
scheduling::scheduling
resources::resources
facilitating::facilitating
recovering::recovering
errors::errors
accounting::accounting
usage::usage
parallel::parallel
operations::operations
organizing::organizing
secure::secure
rapid::rapid
access::access
handling::handling
network::network
communications::communications
objectives::objectives
modern::modern
major::major
goals::goals
accomplish::accomplish
running::running
low::low
privilege::privilege
invoke::invoke
high-privilege::high-privilege
hide::hide
details::details
creating::creating
abstraction::abstraction
hides::hides
lower::lower
level::level
higher-level::higher-level
transforms::transforms
physical::physical
world::world
memory::memory
virtual::virtual
result::result
abstractions::abstractions
built::built
reasons::reasons
first::first
code::code
needed::needed
standardized::standardized
provide::provide
subroutines::subroutines
device::device
drivers::drivers
behalf::behalf
introduces::introduces
abstracts::abstracts
instance::instance
file::file
deal::deal
disks::disks
multiple::multiple
computers::computers
belonging::belonging
process::process
views::views
lens::lens
fourth::fourth
enforce::enforce
security::security
allocate::allocate
manage::manage
active::active
agents::agents
passive::passive
entities::entities
pleasant::pleasant
effective::effective
interacts::interacts
interested::interested
feel::feel
important::important
components::components
command::command
interpreter::interpreter
on-line::on-line
application::application
integration::integration
recent::recent
trend::trend
increasingly::increasingly
integrated::integrated
graphical::graphical
interfaces::interfaces
encompass::encompass
activities::activities
networks::networks
view::view
two::two
points::points
manager::manager
extended::extended
machines::machines
point::point
parts::parts
efficiently::efficiently
machine::machine
convenient::convenient
structurally::structurally
design::design
monolithic::monolithic
hierarchy::hierarchy
layers::layers
exokernel::exokernel
client-server::client-server
model::model
basic::basic
concepts::concepts
management::management
i::NNP
history::history
historically::historically
tightly::tightly
related::related
architecture::architecture
good::good
idea::idea
study::study
evolved::evolved
number::number
distinct::distinct
phases::phases
generations::generations
corresponds::corresponds
roughly::roughly
decades::decades
earliest::earliest
electronic::electronic
digital::digital
primitive::primitive
entered::entered
bit::bit
rows::rows
mechanical::mechanical
switches::switches
plug::plug
boards::boards
programming::programming
languages::languages
unknown::unknown
assembly::assembly
unheard::unheard
generation::generation
early::early
routine::routine
improved::improved
punch::punch
cards::cards
general::general
motors::motors
research::research
laboratories::laboratories
implemented::implemented
ibm::ibm
ran::ran
job::job
single-stream::single-stream
batch::batch
processing::processing
submitted::submitted
groups::groups
batches::batches
advantage::advantage
jobs::jobs
designers::designers
developed::developed
concept::concept
multiprogramming::multiprogramming
processor::processor
switched::switched
advancing::advancing
keeping::keeping
current::current
paused::paused
wait::wait
operation::operation
complete::complete
cpu::cpu
simply::simply
sat::sat
idle::idle
finished::finished
solution::solution
problem::problem
partition::partition
pieces::pieces
waiting::waiting
feature::feature
third-generation::third-generation
technique::technique
spooling::spooling
simultaneous::simultaneous
line::line
high-speed::high-speed
disk::disk
interposed::interposed
low-speed::low-speed
involved::involved
writing::writing
directly::directly
printer::printer
outputs::outputs
written::written
completion::completion
faster::faster
initiated::initiated
sooner::sooner
printed::printed
note::note
thread::thread
spun::spun
spool::spool
unwound::unwound
present::present
time-sharing::time-sharing
variant::variant
i.e::i.e
connected::connected
terminal::terminal
interacting::interacting
respond::respond
quickly::quickly
productivity::productivity
suffer::suffer
timesharing::timesharing
multiprogram::multiprogram
large::large
interactive::interactive
development::development
lsi::lsi
scale::scale
circuits::circuits
chips::chips
personal::personal
workstation::workstation
age::age
microprocessor::microprocessor
technology::technology
build::build
desktop::desktop
powerful::powerful
mainframes::mainframes
1970s::1970s
dominated::dominated
scene::scene
microsoft::microsoft
intel::intel
successors::successors
dominant::dominant
motorola::motorola
family::family
structure::structure
goal::goal
supporting::supporting
types::types
manages::manages
kinds::kinds
ranging::ranging
spooler::spooler
servers::servers
server::server
encapsulated::encapsulated
includes::includes
registers::registers
instant::instant
regard::regard
creation::creation
deletion::deletion
suspension::suspension
resumption::resumption
mechanism::mechanism
synchronization::synchronization
deadlock::deadlock
main-memory::main-memory
primary-memory::primary-memory
array::array
words::words
bytes::bytes
word::word
byte::byte
address::address
memory-management::memory-management
track::track
decide::decide
loaded::loaded
space::space
deallocate::deallocate
collected::collected
information::information
defined::defined
creator::creator
store::store
files::files
secondary::secondary
long::long
term::term
media::media
magnetic::magnetic
tape::tape
optical::optical
properties::properties
speed::speed
capacity::capacity
transfer::transfer
rate::rate
methods::methods
organized::organized
directories::directories
ease::ease
directions::directions
support::support
primitives::primitives
manipulating::manipulating
mapping::mapping
back::back
stable::stable
subsystem::subsystem
peculiarities::peculiarities
specific::specific
driver::driver
assigned::assigned
secondary-storage::secondary-storage
speaking::speaking
including::including
primary::primary
cache::cache
referenced::referenced
small::small
accommodate::accommodate
lost::lost
power::power
consists::consists
tapes::tapes
designed::designed
hold::hold
eventually::eventually
accessed::accessed
ordinarily::ordinarily
divided::divided
consisting::consisting
fixed::fixed
location::location
addresses::addresses
managing::managing
free::free
allocation::allocation
networking::networking
distributed::distributed
collection::collection
clock::clock
communicate::communicate
lines::lines
communication-network::communication-network
routing::routing
connection::connection
strategies::strategies
problems::problems
contention::contention
protection::protection
concurrent::concurrent
protected::protected
refers::refers
commands::commands
turning::turning
function::function
execute::execute
command-interpreter::command-interpreter
interpreters::interpreters
shell::shell
terminology::terminology
mode::mode
advantages::advantages
separating::separating
change::change
separate::separate
modify::modify
malicious::malicious
gain::gain
showed::showed
avoid::avoid
ugly::ugly
scenario::scenario
advantageous::advantageous
provided::provided
convenience::convenience
purpose::purpose
environment::environment
conveniently::conveniently
worry::worry
multitasking::multitasking
things::things
care::care
allocating::allocating
deallocating::deallocating
case::case
multiprocess::multiprocess
user-level::user-level
independently::independently
requires::requires
input::input
produces::produces
output::output
underlying::underlying
sees::sees
performed::performed
makes::makes
manipulation::manipulation
reading::reading
task::task
accomplished::accomplished
easier::easier
depends::depends
critical::critical
relegated::relegated
giving::giving
individual::individual
difficult::difficult
mentioned::mentioned
left::left
instances::instances
exchange::exchange
relieves::relieves
passing::passing
messages::messages
passed::passed
done::done
customized::customized
specifics::specifics
message::message
transits::transits
error::error
detection::detection
malfunctioning::malfunctioning
situation::situation
constantly::constantly
monitors::monitors
detecting::detecting
propagating::propagating
causing::causing
allowed::allowed
handled::handled
monitoring::monitoring
cases::cases
altering::altering
area::area
deallocation::deallocation
faulty::faulty
relinquishing::relinquishing
infinite::infinite
loop::loop
tasks::tasks
handed::handed
privileges::privileges
interfere::interfere
correct::correct
normal::normal
trap::trap
enter::enter
desired::desired
nature::nature
call::call
telling::telling
read::read
write::write
satisfied::satisfied
functioning::functioning
editors::editors
compilers::compilers
shells::shells
sense::sense
bundles::bundles
layered::layered
approach::approach
debug::debug
affect::affect
limited::limited
portions::portions
programmer::programmer
accessible::accessible
ways::ways
bugs::bugs
affecting::affecting
module::module
layer::layer
mechanisms::mechanisms
policies::policies
specifies::specifies
timer::timer
construct::construct
ensuring::ensuring
hand::hand
decision::decision
policy::policy
separation::separation
flexibility::flexibility
parameters::parameters
vague::vague
involve::involve
deeper::deeper
decided::decided
choice::choice
implementation::implementation
changed::changed
efficient::efficient
trouble::trouble
specifically::specifically
variety::variety
implement::implement
changing::changing
require::require
increase::increase
efficiency::efficiency
move::move
platform::platform
