introduction to operating::introduction to operating
program that acts::program that acts
provide an environment::provide an environment
user can execute::user can execute
programs the primary::programs the primary
make the computer::make the computer
computer system convenient::computer system convenient
efficient manner lecture::efficient manner lecture
set of programs::set of programs
programs that controls::programs that controls
controls a computer::controls a computer
computer some examples::computer some examples
examples of operating::examples of operating
os and macos::-NONE- and macos
objectives of operating::objectives of operating
details of hardware::details of hardware
hardware by creating::hardware by creating
resources to processes::resources to processes
provide a pleasant::provide a pleasant
pleasant and effective::pleasant and effective
effective user interface::effective user interface
user interface history::user interface history
history of operating::history of operating
generations the earliest::generations the earliest
earliest electronic digital::earliest electronic digital
electronic digital computers::electronic digital computers
operating systems machines::operating systems machines
primitive that programs::primitive that programs
entered one bit::entered one bit
rows of mechanical::rows of mechanical
languages were unknown::languages were unknown
systems were unheard::systems were unheard
routine had improved::routine had improved
introduction of punch::introduction of punch
cards the general::cards the general
general motors research::general motors research
motors research laboratories::motors research laboratories
research laboratories implemented::research laboratories implemented
implemented the first::implemented the first
first operating systems::first operating systems
systems in early::systems in early
ran one job::ran one job
generation the systems::generation the systems
batch processing systems::batch processing systems
computer s resources::computer s resources
resources by running::resources by running
running several jobs::running several jobs
development of lsi::development of lsi
large scale integration::large scale integration
operating system entered::operating system entered
workstation age microprocessor::workstation age microprocessor
age microprocessor technology::age microprocessor technology
microprocessor technology evolved::microprocessor technology evolved
build desktop computers::build desktop computers
computers as powerful::computers as powerful
operating systems lecture::operating systems lecture
operating systems structure::operating systems structure
structure • system::structure • system
components • operating::components • operating
operating systems services::operating systems services
services • system::services • system
calls and system::calls and system
system programs system::system programs system
programs system components::programs system components
components • process::components • process
management a process::management a process
program in execution::program in execution
system in regard::system in regard
regard to process::regard to process
creation and deletion::creation and deletion
deletion of user::deletion of user
user and system::user and system
processes • suspension::processes • suspension
suspension and resumption::suspension and resumption
resumption of processes::resumption of processes
mechanism for process::mechanism for process
mechanism for deadlock::mechanism for deadlock
deadlock handling system::deadlock handling system
handling system components::handling system components
components • main-memory::components • main-memory
main-memory management main-memory::main-memory management main-memory
array of words::array of words
words or bytes::words or bytes
bytes each word::bytes each word
word or byte::word or byte
address main memory::address main memory
quickly accessible data::quickly accessible data
accessible data shared::accessible data shared
devices the major::devices the major
regard to memory-management::regard to memory-management
part of memory::part of memory
decide which processes::decide which processes
processes are loaded::processes are loaded
loaded into memory::loaded into memory
memory when memory::memory when memory
allocate and deallocate::allocate and deallocate
deallocate memory space::deallocate memory space
space as needed::space as needed
needed system components::needed system components
components • file::components • file
management a file::management a file
collected of related::collected of related
related information defined::related information defined
computer can store::computer can store
provide long term::provide long term
long term storage::long term storage
deletion of files::deletion of files
deletion of directions::deletion of directions
support of primitives::support of primitives
primitives for manipulating::primitives for manipulating
files and directions::files and directions
mapping of files::mapping of files
files onto secondary::files onto secondary
backup of files::backup of files
files on stable::files on stable
stable storage media::stable storage media
storage media system::storage media system
media system components::media system components
i system management::-NONE- system management
hide the peculiarities::hide the peculiarities
peculiarities of specific::peculiarities of specific
specific hardware devices::specific hardware devices
user • secondary-storage::user • secondary-storage
management generally speaking::management generally speaking
levels of storage::levels of storage
including primary storage::including primary storage
storage and cache::storage and cache
cache storage instructions::cache storage instructions
instructions and data::instructions and data
running program system::running program system
program system components::program system components
components • networking::components • networking
networking a distributed::networking a distributed
collection of processors::collection of processors
clock the processors::clock the processors
lines called network::lines called network
network • protection::network • protection
protection system protection::protection system protection
system protection refers::system protection refers
refers to mechanism::refers to mechanism
mechanism for controlling::mechanism for controlling
controlling the access::controlling the access
access of programs::access of programs
system • command::system • command
command interpreter system::command interpreter system
system a command::system a command
user the user::user the user
user gives commands::user gives commands
executed by operating::executed by operating
services • program::services • program
execution the system::execution the system
load a program::load a program
program into memory::program into memory
end its execution::end its execution
operations a running::operations a running
program may require::program may require
i may involve::NNP may involve
involve a file::involve a file
device • file::device • file
file system manipulation::file system manipulation
manipulation the output::manipulation the output
files or input::files or input
files the operating::files the operating
service • error::service • error
detection an error::detection an error
system to avoid::system to avoid
situation the operating::situation the operating
system constantly monitors::system constantly monitors
monitors the system::monitors the system
system for detecting::system for detecting
detecting the errors::detecting the errors
errors system calls::errors system calls
programs • system::programs • system
system calls provide::system calls provide
provide the interface::provide the interface
system these calls::system these calls
operating systems::operating systems
operating system::operating system
computer hardware::computer hardware
execute programs::execute programs
primary goal::primary goal
computer system::computer system
system convenient::system convenient
secondary goal::secondary goal
efficient manner::efficient manner
manner lecture::manner lecture
important part::important part
application programs::application programs
hide details::hide details
creating abstraction::creating abstraction
allocate resources::allocate resources
manage resources::manage resources
effective user::effective user
user interface::user interface
interface history::interface history
first generations::first generations
earliest electronic::earliest electronic
electronic digital::electronic digital
digital computers::digital computers
systems machines::systems machines
mechanical switches::mechanical switches
plug boards::plug boards
programming languages::programming languages
assembly languages::assembly languages
punch cards::punch cards
general motors::general motors
motors research::motors research
research laboratories::research laboratories
laboratories implemented::laboratories implemented
first operating::first operating
processing systems::processing systems
fourth generation::fourth generation
large scale::large scale
scale integration::scale integration
system entered::system entered
personal computer::personal computer
workstation age::workstation age
age microprocessor::age microprocessor
microprocessor technology::microprocessor technology
technology evolved::technology evolved
build desktop::build desktop
desktop computers::desktop computers
systems lecture::systems lecture
systems structure::systems structure
system components::system components
systems services::systems services
system calls::system calls
system programs::system programs
programs system::programs system
process management::process management
major activities::major activities
system processes::system processes
process synchronization::process synchronization
process communication::process communication
deadlock handling::deadlock handling
handling system::handling system
main-memory management::main-memory management
management main-memory::management main-memory
large array::large array
address main::address main
main memory::main memory
accessible data::accessible data
data shared::data shared
memory space::memory space
deallocate memory::deallocate memory
needed system::needed system
file management::file management
related information::related information
information defined::information defined
creator computer::creator computer
store files::store files
secondary storage::secondary storage
long term::long term
term storage::term storage
manipulating files::manipulating files
stable storage::stable storage
storage media::storage media
media system::media system
system management::system management
specific hardware::specific hardware
hardware devices::hardware devices
secondary-storage management::secondary-storage management
primary storage::primary storage
cache storage::cache storage
storage instructions::storage instructions
running program::running program
program system::program system
distributed system::distributed system
share memory::share memory
peripheral devices::peripheral devices
processors communicate::processors communicate
communication lines::communication lines
protection system::protection system
system protection::system protection
protection refers::protection refers
resources defined::resources defined
command interpreter::command interpreter
interpreter system::interpreter system
program execution::program execution
indicating error::indicating error
file system::file system
system manipulation::system manipulation
error detection::error detection
complete system::complete system
constantly monitors::constantly monitors
errors system::errors system
calls provide::calls provide
assembly-language instructions::assembly-language instructions
assembly-language programmers::assembly-language programmers
lecture::lecture
introduction::introduction
operating::operating
systems::systems
system::system
program::program
acts::acts
intermediary::intermediary
user::user
computer::computer
hardware::hardware
purpose::purpose
provide::provide
environment::environment
execute::execute
programs::programs
primary::primary
goal::goal
make::make
convenient::convenient
secondary::secondary
efficient::efficient
manner::manner
set::set
controls::controls
examples::examples
unix::unix
mach::mach
ms-dos::ms-dos
mswindows::mswindows
os::-NONE-
macos::macos
important::important
part::part
divided::divided
roughly::roughly
four::four
components::components
application::application
users::users
figure::figure
objectives::objectives
hide::hide
details::details
creating::creating
abstraction::abstraction
allocate::allocate
resources::resources
processes::processes
manage::manage
pleasant::pleasant
effective::effective
interface::interface
history::history
first::first
generations::generations
earliest::earliest
electronic::electronic
digital::digital
computers::computers
machines::machines
primitive::primitive
entered::entered
bit::bit
rows::rows
mechanical::mechanical
switches::switches
plug::plug
boards::boards
programming::programming
languages::languages
unknown::unknown
assembly::assembly
unheard::unheard
generation::generation
early::early
routine::routine
improved::improved
punch::punch
cards::cards
general::general
motors::motors
research::research
laboratories::laboratories
implemented::implemented
ibm::ibm
generally::generally
ran::ran
job::job
batch::batch
processing::processing
advantage::advantage
running::running
jobs::jobs
fourth::fourth
development::development
lsi::lsi
large::large
scale::scale
integration::integration
circuits::circuits
chips::chips
personal::personal
workstation::workstation
age::age
microprocessor::microprocessor
technology::technology
evolved::evolved
point::point
build::build
desktop::desktop
powerful::powerful
mainframes::mainframes
1970s::1970s
structure::structure
services::services
calls::calls
process::process
management::management
instant::instant
execution::execution
major::major
activities::activities
regard::regard
creation::creation
deletion::deletion
suspension::suspension
resumption::resumption
mechanism::mechanism
synchronization::synchronization
communication::communication
deadlock::deadlock
handling::handling
main-memory::main-memory
array::array
words::words
bytes::bytes
word::word
byte::byte
address::address
main::main
memory::memory
repository::repository
quickly::quickly
accessible::accessible
data::data
shared::shared
cpu::cpu
i::NNP
devices::devices
memory-management::memory-management
track::track
decide::decide
loaded::loaded
space::space
deallocate::deallocate
needed::needed
file::file
collected::collected
related::related
information::information
defined::defined
creator::creator
store::store
files::files
disk::disk
storage::storage
long::long
term::term
directions::directions
support::support
primitives::primitives
manipulating::manipulating
mapping::mapping
backup::backup
stable::stable
media::media
purposes::purposes
peculiarities::peculiarities
specific::specific
secondary-storage::secondary-storage
speaking::speaking
levels::levels
including::including
cache::cache
instructions::instructions
referenced::referenced
networking::networking
distributed::distributed
collection::collection
processors::processors
share::share
peripheral::peripheral
clock::clock
communicate::communicate
lines::lines
network::network
protection::protection
refers::refers
controlling::controlling
access::access
command::command
interpreter::interpreter
commands::commands
executed::executed
turning::turning
load::load
run::run
end::end
abnormally::abnormally
indicating::indicating
error::error
operations::operations
require::require
involve::involve
device::device
manipulation::manipulation
output::output
written::written
input::input
service::service
detection::detection
malfunctioning::malfunctioning
complete::complete
avoid::avoid
situation::situation
constantly::constantly
monitors::monitors
detecting::detecting
errors::errors
assembly-language::assembly-language
listed::listed
manuals::manuals
programmers::programmers
