software that manages::software that manages
manages computer hardware::manages computer hardware
hardware and software::hardware and software
services for computer::services for computer
programs the operating::programs the operating
computer system application::computer system application
system application programs::system application programs
programs usually require::programs usually require
require an operating::require an operating
system to function::system to function
function time sharing::function time sharing
sharing operating systems::sharing operating systems
operating systems schedule::operating systems schedule
systems schedule tasks::systems schedule tasks
tasks for efficient::tasks for efficient
include accounting software::include accounting software
software for cost::software for cost
allocation of processor::allocation of processor
resources for hardware::resources for hardware
input and output::input and output
output and memory::output and memory
operating system acts::operating system acts
intermediary between programs::intermediary between programs
frequently makes system::frequently makes system
makes system calls::makes system calls
systems are found::systems are found
computer from cellular::computer from cellular
phones and video::phones and video
video game consoles::video game consoles
consoles to web::consoles to web
servers and supercomputers::servers and supercomputers
examples of popular::examples of popular
popular modern operating::popular modern operating
modern operating systems::modern operating systems
operating systems include::operating systems include
systems include android::systems include android
z the first::NNP the first
examples share roots::examples share roots
roots in unix::roots in unix
types of operating::types of operating
operating systems single::operating systems single
single and multi::single and multi
tasking a single::tasking a single
single tasking system::single tasking system
run one program::run one program
multi tasking operating::multi tasking operating
tasking operating system::tasking operating system
running in concurrency::running in concurrency
task scheduling subsystem::task scheduling subsystem
operating system multi::operating system multi
system multi tasking::system multi tasking
characterized in pre::characterized in pre
types in pre::types in pre
pre emptive multitasking::pre emptive multitasking
operating system slices::operating system slices
slices the cpu::slices the cpu
dedicates a slot::dedicates a slot
unix like operating::unix like operating
asamigaos support pre::asamigaos support pre
support pre emptive::support pre emptive
emptive multitasking cooperative::emptive multitasking cooperative
multitasking cooperative multitasking::multitasking cooperative multitasking
multitasking is achieved::multitasking is achieved
achieved by relying::achieved by relying
process to provide::process to provide
versions of microsoft::versions of microsoft
windows used cooperative::windows used cooperative
cooperative multi tasking::cooperative multi tasking
pre emptive multi::pre emptive multi
emptive multi tasking::emptive multi tasking
multi tasking single::multi tasking single
multi user single::multi user single
user single user::user single user
single user operating::single user operating
user operating systems::user operating systems
facilities to distinguish::facilities to distinguish
programs to run::programs to run
run in tandem::run in tandem
multi user operating::multi user operating
user operating system::user operating system
operating system extends::operating system extends
extends the basic::extends the basic
concept of multi::concept of multi
tasking with facilities::tasking with facilities
facilities that identify::facilities that identify
processes and resources::processes and resources
belonging to multiple::belonging to multiple
system permits multiple::system permits multiple
permits multiple users::permits multiple users
users to interact::users to interact
resources to multiple::resources to multiple
multiple users distributed::multiple users distributed
distributed a distributed::distributed a distributed
distributed operating system::distributed operating system
operating system manages::operating system manages
manages a group::manages a group
group of distinct::group of distinct
computers and makes::computers and makes
computer the development::computer the development
development of networked::development of networked
linked and communicate::linked and communicate
rise to distributed::rise to distributed
distributed computing distributed::distributed computing distributed
computing distributed computations::computing distributed computations
computations are carried::computations are carried
machine when computers::machine when computers
work in cooperation::work in cooperation
form a distributed::form a distributed
distributed and cloud::distributed and cloud
cloud computing context::cloud computing context
refers to creating::refers to creating
creating a single::creating a single
single virtual machine::single virtual machine
virtual machine image::virtual machine image
guest operating system::guest operating system
tool for multiple::tool for multiple
multiple running virtual::multiple running virtual
running virtual machines::running virtual machines
virtualization and cloud::virtualization and cloud
cloud computing management::cloud computing management
common in large::common in large
large server warehouses::large server warehouses
embedded embedded operating::embedded embedded operating
embedded operating systems::embedded operating systems
systems are designed::systems are designed
embedded computer systems::embedded computer systems
designed to operate::designed to operate
operate on small::operate on small
machines like pdas::machines like pdas
number of resources::number of resources
efficient by design::efficient by design
examples of embedded::examples of embedded
operating systems real::operating systems real
real time operating::real time operating
system that guaranties::system that guaranties
guaranties to process::guaranties to process
events or data::events or data
single or multi::single or multi
specialized scheduling algorithms::specialized scheduling algorithms
nature of behavior::nature of behavior
behavior is achieved::behavior is achieved
achieved an event::achieved an event
event driven system::event driven system
driven system switches::driven system switches
switches between tasks::switches between tasks
priorities or external::priorities or external
operating systems switch::operating systems switch
systems switch tasks::systems switch tasks
switch tasks based::switch tasks based
based on clock::based on clock
clock interrupts history::clock interrupts history
history of operating::history of operating
monitor early computers::monitor early computers
computers were built::computers were built
built to perform::built to perform
perform a series::perform a series
series of single::series of single
calculator basic operating::calculator basic operating
basic operating system::basic operating system
operating system features::operating system features
features were developed::features were developed
resident monitor functions::resident monitor functions
run different programs::run different programs
programs in succession::programs in succession
succession to speed::succession to speed
speed up processing::speed up processing
processing operating systems::processing operating systems
features were added::features were added
parallel processing whenpersonal::parallel processing whenpersonal
processing whenpersonal computers::processing whenpersonal computers
computers became popular::computers became popular
systems were made::systems were made
similar in concept::similar in concept
earliest electronic digital::earliest electronic digital
electronic digital systems::electronic digital systems
operating systems electronic::operating systems electronic
systems electronic systems::systems electronic systems
programmed on rows::programmed on rows
rows of mechanical::rows of mechanical
wires on plug::wires on plug
special purpose systems::special purpose systems
generated ballistics tables::generated ballistics tables
military or controlled::military or controlled
controlled the printing::controlled the printing
printing of payroll::printing of payroll
checks from data::checks from data
data on punched::data on punched
punched paper cards::punched paper cards
cards after programmable::cards after programmable
programmable general purpose::programmable general purpose
general purpose computers::general purpose computers
computers were invented::computers were invented
consisting of strings::consisting of strings
punched paper tape::punched paper tape
introduced that sped::introduced that sped
computer could execute::computer could execute
user had sole::user had sole
program and data::program and data
cards and punched::cards JJ punched
tape the program::tape the program
set to work::set to work
completed or crashed::completed or crashed
generally be debugged::generally be debugged
panel using toggle::panel using toggle
switches and panel::switches and panel
early manchester mark::early manchester mark
deriving the primitive::deriving the primitive
universal turing machine::universal turing machine
libraries of programs::libraries of programs
user s program::user s program
program to assist::program to assist
assist in operations::assist in operations
output and generating::output and generating
generating computer code::generating computer code
code from human::code from human
human readable symbolic::human readable symbolic
readable symbolic code::readable symbolic code
modern day operating::modern day operating
day operating system::day operating system
machines still ran::machines still ran
ran a single::ran a single
university in england::university in england
england the job::england the job
tapes were hung::tapes were hung
colored clothes pegs::colored clothes pegs
priority an improvement::priority an improvement
atlas supervisor introduced::atlas supervisor introduced
manchester atlas commissioned::manchester atlas commissioned
first recognisable modern::first recognisable modern
recognisable modern operating::recognisable modern operating
modern operating system::modern operating system
brinch hansen described::brinch hansen described
history of ibm::history of ibm
ibm mainframe operating::ibm mainframe operating
mainframe operating systems::mainframe operating systems
features were pioneered::features were pioneered
field of operating::field of operating
including batch processing::including batch processing
programs for sorting::programs for sorting
records in files::records in files
files these features::files these features
features were included::features were included
included in application::included in application
option of application::option of application
separate operating system::separate operating system
share operating systemwas::share operating systemwas
operating systemwas released::operating systemwas released
introduced the concept::introduced the concept
single os spanning::single os spanning
spanning an entire::spanning an entire
entire product line::entire product line
system machines ibm::NNP machines ibm
ibm s current::ibm s current
current mainframe operating::current mainframe operating
systems are distant::systems are distant
system and applications::system and applications
run on modern::run on modern
os also pioneered::-NONE- also pioneered
pioneered the concept::pioneered the concept
system keeps track::system keeps track
data space allocation::data space allocation
allocation in main::allocation in main
memory and file::memory and file
space in secondary::space in secondary
locking during update::locking during update
process is terminated::process is terminated
system the alternative::system the alternative
line of ibm::line of ibm
ibm operating systems::ibm operating systems
operating systems focused::operating systems focused
concept of virtual::concept of virtual
machines other operating::machines other operating
ibm s series::ibm -NONE- series
s series mainframes::-NONE- series mainframes
series mainframes included::series mainframes included
mainframes included systems::mainframes included systems
included systems developed::included systems developed
developed by ibm::developed by ibm
compatibility operating system::compatibility operating system
disk operating system::disk operating system
tape operating system::tape operating system
airline control program::airline control program
non ibm systems::non ibm systems
michigan terminal system::michigan terminal system
multi user system::multi user system
system for interactive::system for interactive
stanford timesharing system::stanford timesharing system
control data corporation::control data corporation
data corporation developed::data corporation developed
developed the scope::developed the scope
scope operating system::scope operating system
processing in cooperation::processing in cooperation
university of minnesota::university of minnesota
nos operating systems::nos operating systems
systems were developed::systems were developed
supported simultaneous batch::supported simultaneous batch
batch and timesharing::batch and timesharing
commercial timesharing systems::commercial timesharing systems
dartmouth basic operating::dartmouth basic operating
basic operating systems::basic operating systems
efforts in timesharing::efforts in timesharing
timesharing and programming::timesharing and programming
university of illinois::university of illinois
developed the plato::developed the plato
plato operating system::plato operating system
plasma panel displays::plasma panel displays
displays and long::displays and long
distance time sharing::distance time sharing
sharing networks plato::sharing networks plato
multi user graphical::multi user graphical
user graphical games::user graphical games
burroughs corporation introduced::burroughs corporation introduced
introduced the b5000::introduced the b5000
master control program::master control program
system the b5000::system the b5000
stack machine designed::stack machine designed
exclusively support high::exclusively support high
support high level::support high level
high level languages::high level languages
language or assembler::language or assembler
high level language::high level language
level language espol::level language espol
dialect of algol::dialect of algol
mcp also introduced::mcp also introduced
ground breaking innovations::ground breaking innovations
first commercial implementation::first commercial implementation
commercial implementation ofvirtual::commercial implementation ofvirtual
implementation ofvirtual memory::implementation ofvirtual memory
memory during development::memory during development
made an approach::made an approach
approach to burroughs::approach to burroughs
burroughs to licence::burroughs to licence
mcp to run::mcp to run
hardware this proposal::hardware this proposal
proposal was declined::proposal was declined
declined by burroughs::declined by burroughs
management to protect::management to protect
protect its existing::protect its existing
existing hardware production::existing hardware production
hardware production mcp::hardware production mcp
unisys clearpath line::unisys -NONE- line
line of computers::line of computers
first commercial computer::first commercial computer
commercial computer manufacturer::commercial computer manufacturer
produced a series::produced a series
series of exec::series of exec
exec operating systems::exec operating systems
early main frame::early main frame
main frame systems::main frame systems
batch oriented system::batch oriented system
oriented system managed::oriented system managed
system managed magnetic::system managed magnetic
managed magnetic drums::managed magnetic drums
readers and line::readers and line
produced the real::produced the real
real time basic::real time basic
system to support::system to support
support large scale::support large scale
scale time sharing::scale time sharing
dartmouth bc system::dartmouth bc system
system general electric::system general electric
electric and mit::electric and mit
mit developed general::mit developed general
developed general electric::developed general electric
general electric comprehensive::general electric comprehensive
electric comprehensive operating::electric comprehensive operating
comprehensive operating supervisor::comprehensive operating supervisor
concept of ringed::concept of ringed
ringed security privilege::ringed security privilege
security privilege levels::security privilege levels
levels after acquisition::levels after acquisition
acquisition by honeywell::acquisition by honeywell
renamed general comprehensive::renamed general comprehensive
general comprehensive operating::general comprehensive operating
comprehensive operating system::comprehensive operating system
digital equipment corporation::digital equipment corporation
equipment corporation developed::equipment corporation developed
developed many operating::developed many operating
system in universities::system in universities
hardware capabilities evolved::hardware capabilities evolved
evolved that allowed::evolved that allowed
similar or ported::similar or ported
software to run::software to run
system early systems::system early systems
systems had utilized::systems had utilized
microprogramming to implement::microprogramming to implement
systems in order::systems in order
order to permit::order to permit
permit different underlying::permit different underlying
underlying computer architectures::underlying computer architectures
series in fact::series in fact
implementations the enormous::implementations the enormous
investment in software::investment in software
original computer manufacturers::original computer manufacturers
manufacturers to continue::manufacturers to continue
continue to develop::continue to develop
develop compatible operating::develop compatible operating
compatible operating systems::compatible operating systems
hardware notable supported::hardware notable supported
notable supported mainframe::notable supported mainframe
supported mainframe operating::supported mainframe operating
burroughs mcp b5000::burroughs mcp b5000
present * ibm::present * ibm
ibm os ibm::ibm -NONE- ibm
present * univac::present * univac
unisys clearpath dorado::unisys clearpath dorado
microcomputers pc dos::microcomputers pc dos
early personal computer::early personal computer
featured a command::featured a command
command line interface::command line interface
line interface mac::line interface mac
feature a graphical::feature a graphical
graphical user interface::graphical user interface
windows and icons::windows and icons
commonplace in guis::commonplace in guis
guis the first::guis the first
elaborate operating systems::elaborate operating systems
developed for mainframes::developed for mainframes
mainframes and minis::mainframes and minis
minis ; minimalistic::minis ; minimalistic
minimalistic operating systems::minimalistic operating systems
loaded from romand::loaded from romand
monitors one notable::monitors one notable
notable early disk::notable early disk
early disk operating::early disk operating
imitated by microsoft::imitated by microsoft
operating system chosen::operating system chosen
ibm s version::ibm s version
abandoned its popular::abandoned its popular
apple ii series::apple ii series
series of microcomputers::series of microcomputers
microcomputers to introduce::microcomputers to introduce
introduce the apple::introduce the apple
innovative graphical user::innovative graphical user
architecture and paging::architecture and paging
provided personal computers::provided personal computers
ability to run::ability to run
run multitasking operating::run multitasking operating
multitasking operating systems::multitasking operating systems
earlier minicomputers andmainframes::earlier minicomputers andmainframes
minicomputers andmainframes microsoft::minicomputers andmainframes microsoft
andmainframes microsoft responded::andmainframes microsoft responded
progress by hiring::progress by hiring
hiring dave cutler::hiring dave cutler
developed the vms::developed the vms
vms operating system::vms operating system
system for digital::system for digital
lead the development::lead the development
windows nt operating::windows nt operating
continues to serve::continues to serve
basis for microsoft::basis for microsoft
microsoft s operating::microsoft s operating
operating systems line::operating systems line
systems line steve::systems line steve
line steve jobs::line steve jobs
founder of apple::founder of apple
started next computer::started next computer
developed the nextstep::developed the nextstep
nextstep operating system::nextstep operating system
operating system nextstep::operating system nextstep
acquired by apple::acquired by apple
code from freebsd::code from freebsd
core of mac::core of mac
project was started::project was started
started by activist::started by activist
activist and programmer::activist and programmer
programmer richard stallman::programmer richard stallman
goal of creating::goal of creating
creating a completefree::creating a completefree
completefree software replacement::completefree software replacement
proprietary unix operating::proprietary unix operating
unix operating system::unix operating system
successful in duplicating::successful in duplicating
duplicating the functionality::duplicating the functionality
parts of unix::parts of unix
gnu hurd kernel::gnu hurd kernel
hurd kernel proved::hurd kernel proved
finnish computer science::finnish computer science
computer science student::computer science student
science student linus::science student linus
student linus torvalds::student linus torvalds
cooperation from volunteers::cooperation from volunteers
released the first::released the first
gnuuser space components::gnuuser space components
components and system::components and system
software to form::software to form
form a complete::form a complete
complete operating system::complete operating system
two major components::two major components
simply " linux::simply " linux
convention that stallman::convention that stallman
free software foundation::free software foundation
software foundation remain::software foundation remain
foundation remain opposed::foundation remain opposed
gnu the berkeley::NNP the berkeley
berkeley software distribution::berkeley software distribution
unix derivative distributed::unix derivative distributed
university of california::university of california
1970s freely distributed::1970s freely distributed
distributed and ported::distributed and ported
eventually also gained::eventually also gained
netbsd and openbsd::netbsd and openbsd
examples of operating::examples of operating
operating systems unix::operating systems unix
unix and unix::unix and unix
operating systems evolution::operating systems evolution
evolution of unix::evolution of unix
ken thompson wrote::ken thompson wrote
based on bcpl::based on bcpl
family of inter::family of inter
inter related operating::inter related operating
related operating systems::related operating systems
unix like family::unix like family
group of operating::group of operating
major sub categories::major sub categories
sub categories including::sub categories including
categories including system::categories including system
group which licenses::group which licenses
shown to conform::shown to conform
definitions " unix::definitions " unix
set of operating::set of operating
systems which resemble::systems which resemble
resemble the original::resemble the original
original unix unix::original unix unix
unix like systems::unix like systems
variety of computer::variety of computer
heavily for servers::heavily for servers
servers in business::servers in business
workstations in academic::workstations in academic
academic and engineering::academic and engineering
engineering environments free::engineering environments free
environments free unix::environments free unix
free unix variants::free unix variants
linux and bsd::linux and bsd
areas four operating::areas four operating
four operating systems::four operating systems
systems are certified::systems are certified
ibm s aix::ibm s aix
system v unix::system v unix
designed to run::designed to run
vendor s hardware::vendor s hardware
hardware in contrast::hardware in contrast
microsystems s solaris::microsystems s solaris
solaris operating system::solaris operating system
system can run::system can run
run on multiple::run on multiple
types of hardware::types of hardware
x86 and sparc::x86 and sparc
replacement for apple::replacement for apple
apple s earlier::apple s earlier
hybrid kernel based::hybrid kernel based
kernel based bsd::kernel based bsd
based bsd variant::based bsd variant
bsd variant derived::bsd variant derived
derived from nextstep::derived from nextstep
freebsd unix interoperability::freebsd unix interoperability
interoperability was sought::interoperability was sought
sought by establishing::sought by establishing
establishing the posix::establishing the posix
standard the posix::standard the posix
unix variants bsd::unix variants bsd
descendants a subgroup::descendants a subgroup
software distribution family::software distribution family
andopenbsd these operating::andopenbsd these operating
found on webservers::found on webservers
existence to bsd::existence to bsd
computers to connect::computers to connect
send and receive::send and receive
implemented and refined::implemented and refined
refined in bsd::refined in bsd
bsd the world::bsd the world
world wide web::world wide web
number of computers::number of computers
based on bsd::based on bsd
bsd called nextstep::bsd called nextstep
installed its first::installed its first
first unix system::first unix system
students and staff::students and staff
computer science department::computer science department
department there began::department there began
adding new programs::adding new programs
programs to make::programs to make
make things easier::make things easier
ors when berkeley::ors when berkeley
received new vax::received new vax
school s undergraduates::school s undergraduates
computer s hardware::computer s hardware
possibilities the defense::possibilities the defense
defense advanced research::defense advanced research
advanced research projects::advanced research projects
research projects agency::research projects agency
department of defense::department of defense
defense took interest::defense took interest
decided to fund::decided to fund
fund the project::fund the project
project many schools::project many schools
organizations took notice::organizations took notice
notice and started::notice and started
berkeley s version::berkeley s version
version of unix::version of unix
official one distributed::official one distributed
distributed by at&t::distributed by at&t
at&t steve jobs::at&t steve jobs
company that manufactured::company that manufactured
manufactured high end::manufactured high end
high end computers::high end computers
end computers running::end computers running
variation of bsd::variation of bsd
tim berners lee::tim berners lee
webserver to create::webserver to create
create the world::create the world
wide web developers::wide web developers
developers like keith::developers like keith
keith bostic encouraged::keith bostic encouraged
encouraged the project::encouraged the project
project to replace::project to replace
replace any non::replace any non
non free code::non free code
code that originated::code that originated
originated with bell::originated with bell
years of legal::years of legal
spawned a number::spawned a number
number of free::number of free
freebsd and netbsd::freebsd and netbsd
standard user interface::standard user interface
line of open::line of open
open core graphical::open core graphical
core graphical operating::core graphical operating
graphical operating systems::graphical operating systems
operating systems developed::operating systems developed
shipping macintosh computers::shipping macintosh computers
apple s primary::apple s primary
primary operating system::primary operating system
unlike its predecessor::unlike its predecessor
operating system built::operating system built
built on technology::built on technology
purchased the company::purchased the company
company in early::company in early
system was first::system was first
desktop oriented version::desktop oriented version
v10.0 " cheetah::v10.0 " cheetah
distinct " client::distinct " client
server " ions::server " ions
two were merged::two were merged
v10.8 are named::v10.8 are named
named after big::named after big
big cats starting::big cats starting
starting with v10.9::starting with v10.9
versions are named::versions are named
named after inspirational::named after inspirational
places in california::places in california
announced and released::announced and released
released on june::released on june
ran on apple::ran on apple
apple s line::apple s line
line of macintosh::line of macintosh
macintosh server hardware::macintosh server hardware
server included work::server included work
included work group::included work group
work group management::work group management
management and administration::management and administration
administration software tools::administration software tools
tools that provide::tools that provide
provide simplified access::provide simplified access
access to key::access to key
key network services::key network services
including a mail::including a mail
mail transfer agent::mail transfer agent
domain name server::domain name server
aspects of mac::aspects of mac
product re branded::product re branded
dropping " mac::dropping " mac
linux and linux::linux and linux
linux kernel android::linux kernel android
popular mobile operating::popular mobile operating
mobile operating system::mobile operating system
kernel the linux::kernel the linux
linux kernel originated::linux kernel originated
project of linus::project of linus
student in finland::student in finland
finland he posted::finland he posted
newsgroup for computer::newsgroup for computer
students and programmers::students and programmers
support and assistance::support and assistance
assistance from volunteers::assistance from volunteers
volunteers who succeeded::volunteers who succeeded
succeeded in creating::succeeded in creating
creating a complete::creating a complete
complete and functional::complete and functional
functional kernel linux::functional kernel linux
open license model::open license model
linux kernel code::linux kernel code
study and modification::study and modification
range of computing::range of computing
machinery from supercomputers::machinery from supercomputers
supercomputers to smart::supercomputers to smart
watches although estimates::watches although estimates
suggest that linux::suggest that linux
cell phones linux::cell phones linux
linux has superseded::linux has superseded
ten most powerful::ten most powerful
mint and google::mint and google
google s android::google s android
android google chromium::android google chromium
chromium os chromium::chromium os chromium
operating system based::operating system based
kernel and designed::kernel and designed
designed by google::designed by google
google since chromium::google since chromium
chromium os targets::chromium os targets
targets computer users::targets computer users
users who spend::users who spend
browser with limited::browser with limited
run local applications::run local applications
built in file::built in file
manager and media::manager and media
relies on internet::relies on internet
browser to accomplish::browser to accomplish
chromium os differs::chromium os differs
differs from chrome::differs from chrome
chromium is open::chromium is open
primarily by developers::primarily by developers
developers whereas chrome::developers whereas chrome
operating system shipped::operating system shipped
out in chromebooks::out in chromebooks
microsoft windows microsoft::microsoft windows microsoft
windows microsoft windows::windows microsoft windows
family of proprietary::family of proprietary
proprietary operating systems::proprietary operating systems
operating systems designed::operating systems designed
designed by microsoft::designed by microsoft
targeted to intel::targeted to intel
intel architecture based::intel architecture based
architecture based computers::architecture based computers
percent total usage::percent total usage
total usage share::total usage share
share on web::share on web
web connected computers::web connected computers
version is windows::version is windows
workstations and windows::workstations and windows
recently overtook windows::recently overtook windows
microsoft windows originated::microsoft windows originated
operating environment running::operating environment running
running on top::running on top
standard operating system::standard operating system
intel architecture personal::intel architecture personal
architecture personal computers::architecture personal computers
bootstrap for backwards::bootstrap for backwards
win9x could run::win9x could run
run real mode::run real mode
mode ms dos::mode ms dos
family later versions::family later versions
windows nt kernel::windows nt kernel
kernel current client::kernel current client
current client versions::current client versions
versions of windows::versions of windows
bit arm microprocessors::bit arm microprocessors
supported in older::supported in older
older server version::older server version
server version windows::server version windows
version windows server::version windows server
windows nt supported::windows nt supported
supported additional architectures::supported additional architectures
additional architectures server::additional architectures server
architectures server ions::architectures server ions
ions of windows::ions of windows
microsoft has expended::microsoft has expended
expended significant capital::expended significant capital
effort to promote::effort to promote
server operating system::server operating system
windows  usage::windows  usage
usage on servers::usage on servers
competes against linux::competes against linux
bsd for server::bsd for server
server market share::server market share
windows operating system::windows operating system
os from ibm::-NONE- from ibm
ibm and microsoft::ibm and microsoft
microsoft ; mac::microsoft ; mac
non unix precursor::non unix precursor
precursor to apple::precursor to apple
apple s mac::apple s mac
beos ; xts::beos ; xts
morphos ; haiku::morphos ; haiku
haiku ; baremetal::haiku ; baremetal
baremetal and freemint::baremetal and freemint
markets and continue::markets and continue
developed as minority::developed as minority
platforms for enthusiast::platforms for enthusiast
communities and specialist::communities and specialist
specialist applications openvms::specialist applications openvms
development by hewlett::development by hewlett
exclusively in academia::exclusively in academia
operating systems education::operating systems education
research on operating::research on operating
operating system concepts::operating system concepts
concepts a typical::concepts a typical
system that fulfills::system that fulfills
fulfills both roles::fulfills both roles
purely for research::purely for research
research other operating::research other operating
systems have failed::systems have failed
failed to win::failed to win
win significant market::win significant market
significant market share::significant market share
influenced mainstream operating::influenced mainstream operating
mainstream operating systems::mainstream operating systems
labs  plan::labs  plan
components the components::components the components
system all exist::system all exist
exist in order::exist in order
order to make::order to make
system in order::system in order
mouse or keyboard::mouse or keyboard
internet component kernel::internet component kernel
kernel a kernel::kernel a kernel
connects the application::connects the application
firmware and device::firmware and device
level of control::level of control
devices it manages::devices it manages
manages memory access::manages memory access
access for programs::access for programs
determines which programs::determines which programs
programs get access::programs get access
resets the cpu::resets the cpu
cpu s operating::cpu s operating
states for optimal::states for optimal
organizes the data::organizes the data
long term non::long term non
term non volatile::term non volatile
non volatile storage::non volatile storage
storage with file::storage with file
media as disks::media as disks
program can interact::program can interact
rules and procedures::rules and procedures
system the operating::system the operating
set of services::set of services
services which simplify::services which simplify
development and execution::development and execution
execution of application::execution of application
application programs executing::application programs executing
executing an application::executing an application
application program involves::application program involves
involves the creation::involves the creation
operating system kernel::operating system kernel
kernel which assigns::kernel which assigns
assigns memory space::assigns memory space
establishes a priority::establishes a priority
process in multi::process in multi
multi tasking systems::multi tasking systems
loads program binary::loads program binary
program binary code::program binary code
code into memory::code into memory
hardware devices interrupts::hardware devices interrupts
interrupts are central::interrupts are central
central to operating::central to operating
provide an efficient::provide an efficient
system to interact::system to interact
environment the alternative::environment the alternative
system " watch::system " watch
sources of input::sources of input
input for events::input for events
found in older::found in older
unusual in modern::unusual in modern
systems with large::systems with large
large stacks interrupt::large stacks interrupt
stacks interrupt based::stacks interrupt based
interrupt based programming::interrupt based programming
modern cpus interrupts::modern cpus interrupts
cpus interrupts provide::cpus interrupts provide
provide a computer::provide a computer
automatically saving local::automatically saving local
saving local register::saving local register
local register contexts::local register contexts
running specific code::running specific code
code in response::code in response
response to events::response to events
basic computers support::basic computers support
computers support hardware::computers support hardware
support hardware interrupts::support hardware interrupts
event takes place::event takes place
interrupt is received::interrupt is received
hardware automatically suspends::hardware automatically suspends
suspends whatever program::suspends whatever program
saves its status::saves its status
runs computer code::runs computer code
analogous to placing::analogous to placing
placing a bookmark::placing a bookmark
book in response::book in response
call in modern::call in modern
interrupts are handled::interrupts are handled
system s kernel::system s kernel
hardware device triggers::hardware device triggers
triggers an interrupt::triggers an interrupt
generally by running::generally by running
running some processing::running some processing
code the amount::code the amount
amount of code::amount of code
code being run::code being run
person usually responds::person usually responds
smoke detector alarm::smoke detector alarm
alarm before answering::alarm before answering
answering the phone::answering the phone
processing of hardware::processing of hardware
delegated to software::delegated to software
means a program::means a program
trigger an interrupt::trigger an interrupt
wishes to access::wishes to access
interrupt the operating::interrupt the operating
kernel the kernel::kernel the kernel
kernel then processes::kernel then processes
processes the request::processes the request
program wishes additional::program wishes additional
wishes additional resources::wishes additional resources
wishes to shed::wishes to shed
kernel s attention::kernel s attention
mode and supervisor::mode and supervisor
supervisor mode modern::supervisor mode modern
mode modern cpus::mode modern cpus
modern cpus support::modern cpus support
cpus support multiple::cpus support multiple
support multiple modes::support multiple modes
modes of operation::modes of operation
mode the supervisor::mode the supervisor
kernel for low::kernel for low
low level tasks::low level tasks
access to hardware::access to hardware
controlling how memory::controlling how memory
memory is written::memory is written
written and erased::written and erased
communication with devices::communication with devices
devices like graphics::devices like graphics
graphics cards protected::graphics cards protected
cards protected mode::cards protected mode
operate within protected::operate within protected
hardware by communicating::hardware by communicating
supervisor mode cpus::supervisor mode cpus
similar to protected::similar to protected
modes in order::modes in order
order to emulate::order to emulate
emulate older processor::emulate older processor
older processor types::older processor types
computer first starts::computer first starts
running in supervisor::running in supervisor
mode the first::mode the first
first few programs::first few programs
bios or efi::bios or efi
system have unlimited::system have unlimited
initializing a protected::initializing a protected
operating system passes::operating system passes
system passes control::system passes control
place the cpu::place the cpu
cpu into protected::cpu into protected
mode in protected::mode in protected
cpu s instructions::cpu s instructions
instructions a user::instructions a user
program may leave::program may leave
leave protected mode::leave protected mode
triggering an interrupt::triggering an interrupt
system can maintain::system can maintain
maintain exclusive control::maintain exclusive control
control over things::control over things
things like access::things like access
hardware and memory::hardware and memory
memory the term::memory the term
term " protected::term " protected
protected mode resource::protected mode resource
allowed to alter::allowed to alter
attempts to alter::attempts to alter
alter these resources::alter these resources
switch to supervisor::switch to supervisor
system can deal::system can deal
operation the program::operation the program
program was attempting::program was attempting
killing the program::killing the program
multiprogramming operating system::multiprogramming operating system
responsible for managing::responsible for managing
managing all system::managing all system
programs this ensures::programs this ensures
interfere with memory::interfere with memory
program since programs::program since programs
programs time share::programs time share
access to memory::access to memory
memory cooperative memory::memory cooperative memory
cooperative memory management::cooperative memory management
early operating systems::early operating systems
programs make voluntary::programs make voluntary
kernel s memory::kernel s memory
exceed their allocated::exceed their allocated
memory this system::memory this system
system of memory::system of memory
affected or overwritten::affected or overwritten
overwritten malicious programs::overwritten malicious programs
programs or viruses::programs or viruses
viruses may purpose::viruses may purpose
purpose y alter::purpose y alter
alter another program::alter another program
program s memory::program s memory
affect the operation::affect the operation
program to crash::program to crash
crash the system::crash the system
system memory protection::system memory protection
memory protection enables::memory protection enables
enables the kernel::enables the kernel
kernel to limit::kernel to limit
limit a process::limit a process
process  access::process  access
computer s memory::computer s memory
memory various methods::memory various methods
methods of memory::methods of memory
memory protection exist::memory protection exist
including memory segmentation::including memory segmentation
segmentation and paging::segmentation and paging
paging all methods::paging all methods
require some level::require some level
level of hardware::level of hardware
protected mode registers::protected mode registers
cpu what memory::cpu what memory
program to access::program to access
attempts to access::attempts to access
access other addresses::access other addresses
enter supervisor mode::enter supervisor mode
placing the kernel::placing the kernel
kernel in charge::kernel in charge
violation or seg::violation or seg
difficult to assign::difficult to assign
assign a meaningful::assign a meaningful
kernel generally resorts::kernel generally resorts
resorts to terminating::resorts to terminating
terminating the offending::terminating the offending
reports the error::reports the error
error windows versions::error windows versions
level of memory::level of memory
faultwould be produced::faultwould be produced
indicating a segmentation::indicating a segmentation
violation had occurred::violation had occurred
crash anyway virtual::crash anyway virtual
memory further information::memory further information
virtual memory addressing::virtual memory addressing
paging or segmentation::paging or segmentation
kernel can choose::kernel can choose
choose what memory::choose what memory
memory each program::memory each program
allowing the operating::allowing the operating
locations for multiple::locations for multiple
range of accessible::range of accessible
kernel is interrupted::kernel is interrupted
exceed its allocated::exceed its allocated
section on memory::section on memory
unix this kind::unix this kind
kind of interrupt::kind of interrupt
interrupt is referred::interrupt is referred
detects a page::detects a page
adjusts the virtual::adjusts the virtual
virtual memory range::virtual memory range
program which triggered::program which triggered
granting it access::granting it access
kernel discretionary power::kernel discretionary power
application s memory::application s memory
memory is stored::memory is stored
stored on disk::stored on disk
media to make::media to make
make that space::make that space
area of memory::area of memory
swapped or exchanged::swapped or exchanged
exchanged on demand::exchanged on demand
demand " virtual::demand " virtual
amount of ram::amount of ram
multitasking and process::multitasking and process
multitasking and cooperative::multitasking and cooperative
cooperative multitasking multitasking::cooperative multitasking multitasking
multitasking multitasking refers::multitasking multitasking refers
running of multiple::running of multiple
multiple independent computer::multiple independent computer
independent computer programs::independent computer programs
computer ; giving::computer ; giving
giving the appearance::giving the appearance
performing the tasks::performing the tasks
execute an operating::execute an operating
program which determines::program which determines
process spends executing::process spends executing
order execution control::order execution control
passed to programs::passed to programs
control is passed::control is passed
cpu and memory::cpu and memory
control is returned::control is returned
passing of control::passing of control
kernel and applications::kernel and applications
switch an early::switch an early
model which governed::model which governed
governed the allocation::governed the allocation
explicitly returning control::explicitly returning control
kernel this means::kernel this means
malicious or malfunctioning::malicious or malfunctioning
hang the entire::hang the entire
enters an infinite::enters an infinite
infinite loop modern::infinite loop modern
loop modern operating::loop modern operating
operating systems extend::operating systems extend
extend the concepts::extend the concepts
concepts of application::concepts of application
preemption to device::preemption to device
drivers and kernel::drivers and kernel
system has preemptive::system has preemptive
control over internal::control over internal
internal run times::internal run times
philosophy governing preemptive::philosophy governing preemptive
governing preemptive multitasking::governing preemptive multitasking
cpu this implies::cpu this implies
allowed to spend::allowed to spend
interrupted to accomplish::interrupted to accomplish
operating system kernels::operating system kernels
system kernels make::system kernels make
interrupt a protected::interrupt a protected
protected mode timer::protected mode timer
timer is set::timer is set
kernel which triggers::kernel which triggers
triggers a return::triggers a return
return to supervisor::return to supervisor
sections on interrupts::sections on interrupts
interrupts and dual::interrupts and dual
dual mode operation::dual mode operation
operating systems cooperative::operating systems cooperative
systems cooperative multitasking::systems cooperative multitasking
computers generally run::computers generally run
run a small::run a small
programs the amigaos::programs the amigaos
first version windows::first version windows
version of microsoft::version of microsoft
microsoft windowswhich enforced::microsoft windowswhich enforced
windowswhich enforced preemptive::windowswhich enforced preemptive
enforced preemptive multitasking::enforced preemptive multitasking
reach the home::reach the home
home user market::home user market
market until windows::market until windows
targeted at professionals::targeted at professionals
access and file::access and file
virtual file system::virtual file system
file system access::file system access
access to data::access to data
stored on disks::stored on disks
operating systems computers::operating systems computers
systems computers store::systems computers store
computers store data::computers store data
data on disks::data on disks
structured in specific::structured in specific
ways in order::ways in order
space the specific::space the specific
files are stored::files are stored
names and attributes::names and attributes
hierarchy of directories::hierarchy of directories
directories or folders::directories or folders
tree early operating::tree early operating
systems generally supported::systems generally supported
supported a single::supported a single
type of disk::type of disk
kind of file::kind of file
system early file::system early file
early file systems::early file systems
systems were limited::systems were limited
kinds of file::kinds of file
names and directory::names and directory
limitations often reflected::limitations often reflected
simpler operating systems::simpler operating systems
operating systems support::operating systems support
support a limited::support a limited
range of options::range of options
options for accessing::options for accessing
accessing storage systems::accessing storage systems
systems like unix::systems like unix
unix and linux::unix and linux
support a technology::support a technology
system or vfs::system or vfs
vfs an operating::vfs an operating
supports a wide::supports a wide
array of storage::array of storage
design or file::design or file
common application programming::common application programming
application programming interface::application programming interface
makes it unnecessary::makes it unnecessary
unnecessary for programs::unnecessary for programs
accessing a vfs::accessing a vfs
system to provide::system to provide
programs with access::programs with access
number of devices::number of devices
variety of file::variety of file
file systems installed::file systems installed
specific device drivers::specific device drivers
drivers and file::drivers and file
file system drivers::file system drivers
drivers a connected::drivers a connected
connected storage device::connected storage device
driver the device::driver the device
device driver understands::device driver understands
understands the specific::understands the specific
translate that language::translate that language
system to access::system to access
access all disk::access all disk
drives on unix::drives on unix
language of block::language of block
driver in place::driver in place
access the contents::access the contents
drive in raw::drive in raw
systems a file::systems a file
file system driver::file system driver
translate the commands::translate the commands
access each specific::access each specific
specific file system::specific file system
set of commands::set of commands
file systems programs::file systems programs
basis of filenames::basis of filenames
gather various information::gather various information
including access permissions::including access permissions
creation and modification::creation and modification
dates various differences::dates various differences
differences between file::differences between file
file systems make::file systems make
systems make supporting::systems make supporting
supporting all file::supporting all file
file systems difficult::file systems difficult
systems difficult allowed::systems difficult allowed
difficult allowed characters::difficult allowed characters
characters in file::characters in file
file attributes makes::file attributes makes
makes the implementation::makes the implementation
system a daunting::system a daunting
daunting task operating::daunting task operating
task operating systems::task operating systems
operating systems tend::operating systems tend
tend to recommend::tend to recommend
systems specifically designed::systems specifically designed
ntfs in windows::ntfs in windows
windows and ext3::windows and ext3
ext3 and reiserfs::ext3 and reiserfs
reiserfs in linux::reiserfs in linux
widely used file::widely used file
general purpose operating::general purpose operating
purpose operating systems::purpose operating systems
linux through ntfs::linux through ntfs
ext2 and reiserfs::-NONE- and reiserfs
support for file::support for file
varied among modern::varied among modern
common file systems::common file systems
systems include support::systems include support
support and drivers::support and drivers
drivers for operating::drivers for operating
operating systems vary::operating systems vary
vary on file::vary on file
file system support::file system support
limited in application::limited in application
types of file::types of file
unlike other operating::unlike other operating
usb flash drive::usb flash drive
file system device::file system device
system device drivers::system device drivers
driver a device::driver a device
type of computer::type of computer
computer software developed::computer software developed
interaction with hardware::interaction with hardware
typically this constitutes::typically this constitutes
constitutes an interface::constitutes an interface
interface for communicating::interface for communicating
specific computer bus::specific computer bus
bus or communications::bus or communications
hardware is connected::hardware is connected
system and software::system and software
specialized hardware dependent::specialized hardware dependent
hardware dependent computer::hardware dependent computer
dependent computer program::dependent computer program
operating system specific::operating system specific
specific that enables::specific that enables
enables another program::enables another program
typically an operating::typically an operating
system or applications::system or applications
applications software package::applications software package
package or computer::package or computer
computer program running::computer program running
requisite interrupt handling::requisite interrupt handling
asynchronous time dependent::asynchronous time dependent
dependent hardware interfacing::dependent hardware interfacing
key design goal::key design goal
goal of device::goal of device
drivers is abstraction::drivers is abstraction
abstraction every model::abstraction every model
model of hardware::model of hardware
class of device::class of device
released by manufacturers::released by manufacturers
manufacturers that provide::manufacturers that provide
provide more reliable::provide more reliable
controlled differently computers::controlled differently computers
control every device::control every device
future to solve::future to solve
solve this problem::solve this problem
systems essentially dictate::systems essentially dictate
type of device::type of device
controlled the function::controlled the function
translate these operating::translate these operating
operating system mandated::operating system mandated
system mandated function::system mandated function
mandated function calls::mandated function calls
calls into device::calls into device
device specific calls::device specific calls
calls in theory::calls in theory
appears to operate::appears to operate
operate as usual::operate as usual
system s point::system s point
point of view::point of view
view under versions::view under versions
windows before vista::windows before vista
vista and versions::vista and versions
versions of linux::versions of linux
entered an infinite::entered an infinite
freeze the system::freeze the system
system more recent::system more recent
operating systems incorporate::operating systems incorporate
systems incorporate kernel::systems incorporate kernel
incorporate kernel preemption::incorporate kernel preemption
interrupts the driver::interrupts the driver
driver to give::driver to give
give it tasks::give it tasks
receives a response::receives a response
support a variety::support a variety
variety of networking::variety of networking
means that computers::means that computers
computers running dissimilar::computers running dissimilar
running dissimilar operating::running dissimilar operating
dissimilar operating systems::dissimilar operating systems
systems can participate::systems can participate
network for sharing::network for sharing
wired or wireless::wired or wireless
wireless connections networks::wireless connections networks
computer s operating::computer s operating
access the resources::access the resources
computer to support::computer to support
resources were connected::resources were connected
computer this includes::computer this includes
networked file systems::networked file systems
sharing another computer::sharing another computer
computer s graphics::computer s graphics
graphics or sound::graphics or sound
hardware some network::hardware some network
networked users direct::networked users direct
users direct access::users direct access
computer s command::computer s command
interface client networking::interface NNP networking
server servers offer::server servers offer
computers and users::computers and users
users these services::users these services
provided through ports::provided through ports
ports or numbered::ports or numbered
numbered access points::numbered access points
address each port::address each port
responsible for handling::responsible for handling
port a daemon::port a daemon
access the local::access the local
local hardware resources::local hardware resources
computer by passing::computer by passing
kernel many operating::kernel many operating
specific or open::specific or open
open networking protocols::open networking protocols
sna on ibm::sna on ibm
decnet on systems::decnet on systems
systems from digital::systems from digital
microsoft specific protocols::microsoft specific protocols
windows specific protocols::windows specific protocols
protocols for specific::protocols for specific
supported such asnfs::supported such asnfs
asnfs for file::asnfs for file
file access protocols::file access protocols
protocols like esound::protocols like esound
network to provide::network to provide
sound from local::sound from local
system s sound::system s sound
sound hardware security::sound hardware security
security a computer::security a computer
computer being secure::computer being secure
number of technologies::number of technologies
technologies working properly::technologies working properly
properly a modern::properly a modern
system provides access::system provides access
devices like networks::devices like networks
kernel the operating::kernel the operating
capable of distinguishing::capable of distinguishing
distinguishing between requests::distinguishing between requests
form of requester::form of requester
process of authentication::process of authentication
password other methods::password other methods
methods of authentication::methods of authentication
cards or biometric::cards or biometric
concept of requester::concept of requester
requester identity isauthorization::requester identity isauthorization
services and resources::services and resources
requester once logged::requester once logged
system are tied::system are tied
requester s user::requester s user
variously configured groups::variously configured groups
groups of users::groups of users
belongs in addition::belongs in addition
model of security::model of security
level of security::level of security
security also offers::security also offers
offers auditing options::offers auditing options
tracking of requests::tracking of requests
requests for access::requests for access
access to resources::access to resources
reading this file::reading this file
possibly harmful requests::possibly harmful requests
out through interrupts::out through interrupts
kernel if programs::kernel if programs
directly access hardware::directly access hardware
hardware and resources::hardware and resources
secured external security::secured external security
external security involves::external security involves
involves a request::involves a request
kind of network::kind of network
network connection external::network connection external
connection external requests::connection external requests
passed through device::passed through device
passed onto applications::passed onto applications
carried out directly::carried out directly
out directly security::out directly security
security of operating::security of operating
highly sensitive data::highly sensitive data
sensitive data held::sensitive data held
held on computers::held on computers
commercial and military::commercial and military
nature the united::nature the united
united statesgovernment department::united statesgovernment department
created the trusted::created the trusted
trusted computer system::trusted computer system
computer system evaluation::computer system evaluation
system evaluation criteria::system evaluation criteria
standard that sets::standard that sets
sets basic requirements::sets basic requirements
requirements for assessing::requirements for assessing
assessing the effectiveness::assessing the effectiveness
effectiveness of security::effectiveness of security
importance to operating::importance to operating
operating system makers::operating system makers
classify and select::classify and select
select trusted operating::select trusted operating
trusted operating systems::trusted operating systems
systems being considered::systems being considered
storage and retrieval::storage and retrieval
retrieval of sensitive::retrieval of sensitive
sensitive or classified::sensitive or classified
classified information network::classified information network
information network services::information network services
network services include::network services include
services include offerings::services include offerings
file transfer protocols::file transfer protocols
line of security::line of security
security are hardware::security are hardware
firewalls or intrusion::firewalls or intrusion
intrusion detection systems::intrusion NN systems
operating system level::operating system level
number of software::number of software
systems most modern::systems most modern
include a software::include a software
enabled by default::enabled by default
default a software::default a software
deny network traffic::deny network traffic
service or application::service or application
running an insecure::running an insecure
telnet or ftp::telnet or ftp
firewall would deny::firewall would deny
deny all traffic::deny all traffic
port an alternative::port an alternative
meet the popek::meet the popek
popek and goldberg::popek and goldberg
goldberg virtualization requirements::goldberg virtualization requirements
running user programs::running user programs
programs as native::programs as native
emulates a processor::emulates a processor
code based system::code based system
java internal security::java internal security
relevant for multi::relevant for multi
multi user systems::multi user systems
read internal security::read internal security
vital if auditing::vital if auditing
bypass the operating::bypass the operating
inclusive of bypassing::inclusive of bypassing
bypassing auditing user::bypassing auditing user
auditing user interface::auditing user interface
operating system user::operating system user
system user interface::system user interface
interface every computer::interface every computer
requires a user::requires a user
interface the user::interface the user
essential if human::essential if human
supported the user::supported the user
user interface views::user interface views
interface views thedirectory::interface views thedirectory
views thedirectory structure::views thedirectory structure
structure and requests::structure and requests
data from input::data from input
input hardware devices::input hardware devices
requests operating system::requests operating system
operating system services::operating system services
services to displayprompts::services to displayprompts
output hardware devices::output hardware devices
monitor or printer::monitor or printer
two most common::two most common
commands are typed::commands are typed
typed out line::typed out line
line by line::line by line
commonly a wimp::commonly a wimp
present graphical user::present graphical user
graphical user interfaces::graphical user interfaces
modern computer systems::modern computer systems
computer systems support::computer systems support
systems support graphical::systems support graphical
support graphical user::support graphical user
implementation of mac::implementation of mac
gui is integrated::gui is integrated
technically a graphical::technically a graphical
operating system service::operating system service
responsive by reducing::responsive by reducing
reducing the number::reducing the number
number of context::number of context
context switches required::context switches required
gui to perform::gui to perform
perform its output::perform its output
functions other operating::functions other operating
systems are modular::systems are modular
separating the graphics::separating the graphics
linux and mac::linux and mac
releases of microsoft::releases of microsoft
windows vista implement::windows vista implement
implement a graphics::implement a graphics
graphics drawing routines::graphics drawing routines
routines of versions::routines of versions
versions between windows::versions between windows
kernel space windows::kernel space windows
kernel many computer::kernel many computer
computer operating systems::computer operating systems
user to install::user to install
install or create::install or create
create any user::create any user
interface they desire::interface they desire
system in conjunction::system in conjunction
conjunction with gnome::conjunction with gnome
gnome or kde::gnome or kde
kde plasma desktop::kde plasma desktop
commonly found setup::commonly found setup
systems a number::systems a number
number ofwindows shell::number ofwindows shell
ofwindows shell replacements::ofwindows shell replacements
released for microsoft::released for microsoft
included windows shell::included windows shell
separated from windows::separated from windows
windows numerous unix::windows numerous unix
numerous unix based::numerous unix based
unix based guis::unix based guis
guis have existed::guis have existed
derived from x11::derived from x11
vendors of unix::vendors of unix
effort to standardize::effort to standardize
1990s to cose::1990s to cose
cose and cde::cose and cde
adoption of gnome::adoption of gnome
prior to free::prior to free
free software based::free software based
software based toolkits::software based toolkits
toolkits and desktop::toolkits and desktop
prevalent toolkit combination::prevalent JJ combination
cde was developed::cde was developed
user interfaces evolve::user interfaces evolve
windows has modified::windows has modified
modified its user::modified its user
version of windows::version of windows
windows is released::windows is released
mac os gui::mac os gui
introduction of mac::introduction of mac
system a real::system a real
operating system intended::operating system intended
intended for applications::intended for applications
applications with fixed::applications with fixed
real time computing::real time computing
include some small::include some small
small embedded systems::small embedded systems
automobile engine controllers::automobile engine controllers
large scale computing::large scale computing
scale computing systems::scale computing systems
systems an early::systems an early
large scale real::large scale real
system was transaction::system was transaction
transaction processing facility::transaction processing facility
processing facility developed::processing facility developed
developed by american::developed by american
airlines and ibm::airlines and ibm
sabre airline reservations::sabre airline reservations
airline reservations system::airline reservations system
reservations system embedded::reservations system embedded
system embedded systems::system embedded systems
linux and rtlinux.windows::linux and rtlinux.windows
system that shares::system that shares
shares similar apis::shares similar apis
apis to desktop::apis to desktop
windows but shares::windows but shares
windows  codebase::windows  codebase
starting with version::starting with version
8.0b some embedded::8.0b some embedded
systems use operating::systems use operating
computing operating system::computing operating system
operating system development::operating system development
hobbyist operating system::hobbyist operating system
system development operating::system development operating
development operating system::development operating system
hobbyist may engage::hobbyist may engage
engage a hobby::engage a hobby
hobby operating system::hobby operating system
existing operating system::existing operating system
users and active::users and active
homebrew " computing::homebrew " computing
simple single board::simple single board
single board computer::single board computer
board computer powered::board computer powered
widespread use operating::widespread use operating
commence by modeling::commence by modeling
modeling an existing::modeling an existing
group of individuals::group of individuals
operating system include::operating system include
system include reactos::system include reactos
reactos and syllable::reactos and syllable
diversity of operating::diversity of operating
systems and portability::systems and portability
portability application software::portability application software
specific operating system::specific operating system
hardware when porting::hardware when porting
porting the application::porting the application
application to run::application to run
names of functions::names of functions
meaning of arguments::meaning of arguments
requiring the application::requiring the application
first operating system::first operating system
system not written::system not written
portable to systems::portable to systems
cost in supporting::cost in supporting
supporting operating systems::supporting operating systems
operating systems diversity::operating systems diversity
applications against software::applications against software
platforms like java::platforms like java
borne the cost::borne the cost
cost of adaptation::cost of adaptation
adaptation to specific::adaptation to specific
specific operating systems::specific operating systems
libraries another approach::libraries another approach
operating system vendors::operating system vendors
vendors to adopt::vendors to adopt
abstraction layers provide::abstraction layers provide
layers provide commonalities::layers provide commonalities
commonalities that reduce::commonalities that reduce
operating system::operating system
manages computer::manages computer
computer hardware::computer hardware
software resources::software resources
common services::common services
computer programs::computer programs
essential component::essential component
system software::system software
computer system::computer system
system application::system application
application programs::application programs
sharing operating::sharing operating
operating systems::operating systems
systems schedule::systems schedule
schedule tasks::schedule tasks
accounting software::accounting software
cost allocation::cost allocation
mass storage::mass storage
hardware functions::hardware functions
memory allocation::memory allocation
system acts::system acts
application code::application code
makes system::makes system
system calls::system calls
cellular phones::cellular phones
video game::video game
game consoles::game consoles
web servers::web servers
supercomputers examples::supercomputers examples
popular modern::popular modern
modern operating::modern operating
systems include::systems include
microsoft windows::microsoft windows
windows phone::windows phone
examples share::examples share
share roots::share roots
unix types::unix types
multi tasking::multi tasking
single tasking::single tasking
tasking system::tasking system
tasking operating::tasking operating
multiple processes::multiple processes
task scheduling::task scheduling
scheduling subsystem::scheduling subsystem
system multi::system multi
operative types::operative types
emptive multitasking::emptive multitasking
system slices::system slices
programs unix::programs unix
asamigaos support::asamigaos support
support pre::support pre
pre emptive::pre emptive
cooperative multitasking::cooperative multitasking
defined manner::defined manner
bit versions::bit versions
cooperative multi::cooperative multi
emptive multi::emptive multi
multi user::multi user
user single::user single
single user::single user
user operating::user operating
distinguish users::distinguish users
multiple programs::multiple programs
system extends::system extends
basic concept::basic concept
identify processes::identify processes
disk space::disk space
multiple users::multiple users
system permits::system permits
permits multiple::permits multiple
users distributed::users distributed
distributed operating::distributed operating
system manages::system manages
distinct computers::distinct computers
single computer::single computer
networked computers::networked computers
gave rise::gave rise
distributed computing::distributed computing
computing distributed::computing distributed
distributed computations::distributed computations
group work::group work
distributed system::distributed system
cloud computing::cloud computing
computing context::computing context
templating refers::templating refers
single virtual::single virtual
virtual machine::virtual machine
machine image::machine image
guest operating::guest operating
multiple running::multiple running
virtual machines::virtual machines
computing management::computing management
large server::large server
server warehouses::server warehouses
embedded operating::embedded operating
embedded computer::embedded computer
computer systems::computer systems
small machines::small machines
limited number::limited number
design windows::design windows
systems real::systems real
process events::process events
short amount::short amount
scheduling algorithms::scheduling algorithms
deterministic nature::deterministic nature
event driven::event driven
driven system::driven system
system switches::system switches
tasks based::tasks based
external events::external events
systems switch::systems switch
switch tasks::switch tasks
clock interrupts::clock interrupts
interrupts history::interrupts history
resident monitor::resident monitor
early computers::early computers
single tasks::single tasks
basic operating::basic operating
system features::system features
monitor functions::monitor functions
processing operating::processing operating
complex forms::complex forms
hardware features::hardware features
runtime libraries::runtime libraries
parallel processing::parallel processing
whenpersonal computers::whenpersonal computers
larger computers::larger computers
earliest electronic::earliest electronic
electronic digital::electronic digital
digital systems::digital systems
electronic systems::electronic systems
mechanical switches::mechanical switches
jumper wires::jumper wires
plug boards::plug boards
special purpose::special purpose
purpose systems::purpose systems
generated ballistics::generated ballistics
ballistics tables::ballistics tables
payroll checks::payroll checks
punched paper::punched paper
paper cards::paper cards
programmable general::programmable general
general purpose::general purpose
purpose computers::purpose computers
machine languages::machine languages
binary digits::binary digits
paper tape::paper tape
programming process::programming process
limited period::limited period
punched tape::punched tape
program completed::program completed
crashed programs::crashed programs
front panel::front panel
toggle switches::toggle switches
panel lights::panel lights
alan turing::alan turing
early manchester::early manchester
manchester mark::manchester mark
primitive conception::primitive conception
universal turing::universal turing
turing machine::turing machine
generating computer::generating computer
computer code::computer code
human readable::human readable
readable symbolic::readable symbolic
symbolic code::symbolic code
modern day::modern day
day operating::day operating
single job::single job
cambridge university::cambridge university
job queue::job queue
washing line::washing line
colored clothes::colored clothes
clothes pegs::clothes pegs
job priority::job priority
atlas supervisor::atlas supervisor
supervisor introduced::supervisor introduced
manchester atlas::manchester atlas
first recognisable::first recognisable
recognisable modern::recognisable modern
brinch hansen::brinch hansen
hansen described::hansen described
mainframe computer::mainframe computer
ibm mainframe::ibm mainframe
mainframe operating::mainframe operating
major features::major features
including batch::including batch
batch processing::batch processing
sorting records::sorting records
application software::application software
application programmers::application programmers
separate operating::separate operating
share operating::share operating
operating systemwas::operating systemwas
integrated utility::integrated utility
entire product::entire product
product line::product line
machines ibm::machines ibm
current mainframe::current mainframe
distant descendants::distant descendants
original system::original system
applications written::applications written
modern machines::modern machines
system resources::system resources
including program::including program
data space::data space
space allocation::space allocation
main memory::main memory
file space::file space
secondary storage::secondary storage
ibm operating::ibm operating
systems focused::systems focused
series mainframes::series mainframes
mainframes included::mainframes included
included systems::included systems
systems developed::systems developed
compatibility operating::compatibility operating
disk operating::disk operating
sharing system::sharing system
tape operating::tape operating
airline control::airline control
control program::control program
non ibm::non ibm
ibm systems::ibm systems
michigan terminal::michigan terminal
terminal system::terminal system
user system::user system
interactive computing::interactive computing
stanford timesharing::stanford timesharing
timesharing system::timesharing system
control data::control data
data corporation::data corporation
corporation developed::corporation developed
scope operating::scope operating
nos operating::nos operating
simultaneous batch::simultaneous batch
commercial timesharing::commercial timesharing
timesharing systems::timesharing systems
pioneering efforts::pioneering efforts
programming languages::programming languages
illinois developed::illinois developed
plato operating::plato operating
plasma panel::plasma panel
panel displays::panel displays
long distance::long distance
sharing networks::sharing networks
networks plato::networks plato
graphical games::graphical games
burroughs corporation::burroughs corporation
corporation introduced::corporation introduced
master control::master control
stack machine::stack machine
machine designed::machine designed
high level::high level
level languages::level languages
machine language::machine language
level language::level language
language espol::language espol
algol mcp::algol mcp
ground breaking::ground breaking
breaking innovations::breaking innovations
first commercial::first commercial
commercial implementation::commercial implementation
ofvirtual memory::ofvirtual memory
ibm made::ibm made
licence mcp::licence mcp
as400 hardware::as400 hardware
burroughs management::burroughs management
existing hardware::existing hardware
hardware production::hardware production
production mcp::production mcp
computers univac::computers univac
commercial computer::commercial computer
computer manufacturer::computer manufacturer
exec operating::exec operating
early main::early main
main frame::main frame
frame systems::frame systems
batch oriented::batch oriented
oriented system::oriented system
system managed::system managed
magnetic drums::magnetic drums
card readers::card readers
line printers::line printers
univac produced::univac produced
large scale::large scale
general electric::general electric
mit developed::mit developed
electric comprehensive::electric comprehensive
comprehensive operating::comprehensive operating
operating supervisor::operating supervisor
ringed security::ringed security
security privilege::security privilege
privilege levels::privilege levels
general comprehensive::general comprehensive
digital equipment::digital equipment
equipment corporation::equipment corporation
computer lines::computer lines
including tops::including tops
sharing systems::sharing systems
bit pdp::bit pdp
class systems::class systems
popular system::popular system
early arpanetcommunity::early arpanetcommunity
hardware capabilities::hardware capabilities
capabilities evolved::capabilities evolved
ported software::ported software
implement features::implement features
underlying computer::underlying computer
computer architectures::computer architectures
enormous investment::enormous investment
systems made::systems made
original computer::original computer
computer manufacturers::computer manufacturers
compatible operating::compatible operating
supported mainframe::supported mainframe
burroughs mcp::burroughs mcp
mcp b5000::mcp b5000
univac exec::univac exec
unisys clearpath::unisys clearpath
clearpath dorado::clearpath dorado
present microcomputers::present microcomputers
early personal::early personal
personal computer::personal computer
command line::command line
line interface::line interface
interface mac::interface mac
apple computer::apple computer
first widespread::first widespread
graphical user::graphical user
user interface::user interface
first microcomputers::first microcomputers
elaborate operating::elaborate operating
minimalistic operating::minimalistic operating
notable early::notable early
early disk::early disk
early microcomputers::early microcomputers
system chosen::system chosen
ibm dos::ibm dos
popular apple::popular apple
apple macintoshcomputer::apple macintoshcomputer
innovative graphical::innovative graphical
cpu chip::cpu chip
bit architecture::bit architecture
paging capabilities::paging capabilities
personal computers::personal computers
run multitasking::run multitasking
multitasking operating::multitasking operating
earlier minicomputers::earlier minicomputers
minicomputers andmainframes::minicomputers andmainframes
andmainframes microsoft::andmainframes microsoft
microsoft responded::microsoft responded
hiring dave::hiring dave
dave cutler::dave cutler
vms operating::vms operating
systems line::systems line
line steve::line steve
steve jobs::steve jobs
nextstep operating::nextstep operating
system nextstep::system nextstep
gnu project::gnu project
programmer richard::programmer richard
richard stallman::richard stallman
completefree software::completefree software
software replacement::software replacement
proprietary unix::proprietary unix
unix operating::unix operating
gnu hurd::gnu hurd
hurd kernel::hurd kernel
kernel proved::kernel proved
finnish computer::finnish computer
computer science::computer science
science student::science student
student linus::student linus
linus torvalds::linus torvalds
volunteers collaborating::volunteers collaborating
first version::first version
linux kernel::linux kernel
gnuuser space::gnuuser space
space components::space components
complete operating::complete operating
major components::major components
software industry::software industry
naming convention::naming convention
free software::free software
software foundation::software foundation
foundation remain::foundation remain
remain opposed::remain opposed
berkeley software::berkeley software
software distribution::software distribution
openbsd examples::openbsd examples
systems unix::systems unix
systems evolution::systems evolution
unix systems::unix systems
unix unix::unix unix
assembly language::assembly language
ken thompson::ken thompson
thompson wrote::thompson wrote
multics project::multics project
complex family::complex family
inter related::inter related
related operating::related operating
diverse group::diverse group
major sub::major sub
sub categories::sub categories
categories including::categories including
including system::including system
open group::open group
large set::large set
original unix::original unix
systems run::systems run
wide variety::wide variety
engineering environments::engineering environments
free unix::free unix
unix variants::unix variants
unix trademark::unix trademark
respective vendor::respective vendor
sun microsystems::sun microsystems
solaris operating::solaris operating
multiple types::multiple types
including x86::including x86
sparc servers::sparc servers
pcs apple::pcs apple
non unix::non unix
hybrid kernel::hybrid kernel
kernel based::kernel based
based bsd::based bsd
bsd variant::bsd variant
variant derived::variant derived
freebsd unix::freebsd unix
unix interoperability::unix interoperability
posix standard::posix standard
variants bsd::variants bsd
unix family::unix family
distribution family::distribution family
internet owes::internet owes
receive data::receive data
world wide::world wide
wide web::wide web
computers running::computers running
nextstep bsd::nextstep bsd
berkeley installed::berkeley installed
first unix::first unix
unix system::unix system
science department::science department
make things::make things
text ors::text ors
berkeley received::berkeley received
vax computers::vax computers
undergraduates modified::undergraduates modified
hardware possibilities::hardware possibilities
defense advanced::defense advanced
advanced research::advanced research
research projects::research projects
projects agency::projects agency
government organizations::government organizations
at&t steve::at&t steve
leaving apple::leaving apple
high end::high end
end computers::end computers
bsd callednextstep::bsd callednextstep
tim berners::tim berners
berners lee::berners lee
first webserver::first webserver
web developers::web developers
bostic encouraged::bostic encouraged
free code::free code
bell labs::bell labs
at&t sued::at&t sued
legal disputes::legal disputes
bsd project::bsd project
free derivatives::free derivatives
standard user::standard user
open core::open core
graphical operating::graphical operating
sold byapple::sold byapple
shipping macintosh::shipping macintosh
macintosh computers::macintosh computers
original mac::original mac
primary operating::primary operating
system built::system built
apple purchased::apple purchased
desktop oriented::desktop oriented
oriented version::oriented version
big cats::big cats
cats starting::cats starting
inspirational places::inspirational places
recent version::recent version
server ion::server ion
desktop counterpart::desktop counterpart
macintosh server::macintosh server
server hardware::server hardware
included work::included work
work group::work group
group management::group management
administration software::administration software
software tools::software tools
simplified access::simplified access
key network::key network
network services::network services
mail transfer::mail transfer
transfer agent::transfer agent
samba server::samba server
ldap server::ldap server
server aspects::server aspects
client version::client version
server tools::server tools
kernel android::kernel android
popular mobile::popular mobile
mobile operating::mobile operating
modified version::modified version
kernel originated::kernel originated
side project::side project
university student::university student
posted information::posted information
computer students::computer students
received support::received support
functional kernel::functional kernel
kernel linux::kernel linux
unix code::unix code
unlike bsd::unlike bsd
open license::open license
license model::license model
kernel code::kernel code
wide range::wide range
computing machinery::computing machinery
smart watches::smart watches
estimates suggest::estimates suggest
embedded systems::embedded systems
cell phones::cell phones
phones linux::phones linux
superseded unix::superseded unix
powerful supercomputers::powerful supercomputers
popular distributions::popular distributions
red hat::red hat
linux mint::linux mint
android google::android google
google chromium::google chromium
system based::system based
targets computer::targets computer
computer users::computer users
web browser::web browser
limited ability::limited ability
local applications::local applications
file manager::file manager
media player::media player
internet applications::internet applications
web apps::web apps
accomplish tasks::accomplish tasks
word processing::word processing
open source::open source
system shipped::system shipped
windows microsoft::windows microsoft
proprietary operating::proprietary operating
systems designed::systems designed
microsoft corporation::microsoft corporation
intel architecture::intel architecture
architecture based::architecture based
based computers::based computers
percent total::percent total
total usage::total usage
usage share::usage share
web connected::web connected
connected computers::connected computers
newest version::newest version
servers windows::servers windows
overtook windows::overtook windows
operating environment::operating environment
environment running::environment running
standard operating::standard operating
backwards compatibility::backwards compatibility
real mode::real mode
bits windows::bits windows
drivers windows::drivers windows
last version::last version
win9x family::win9x family
current client::current client
client versions::client versions
windows run::windows run
bit arm::bit arm
arm microprocessors::arm microprocessors
older server::older server
server version::server version
version windows::version windows
windows server::windows server
additional architectures::additional architectures
architectures server::architectures server
server ions::server ions
recent years::recent years
significant capital::significant capital
server operating::server operating
windows competes::windows competes
server market::server market
market share::market share
windows operating::windows operating
unix precursor::unix precursor
niche markets::niche markets
minority platforms::minority platforms
enthusiast communities::enthusiast communities
specialist applications::specialist applications
applications openvms::applications openvms
active development::active development
hewlett packard::hewlett packard
systems education::systems education
system concepts::system concepts
significant market::significant market
introduced innovations::introduced innovations
influenced mainstream::influenced mainstream
mainstream operating::mainstream operating
computer work::computer work
user software::user software
internet component::internet component
component kernel::component kernel
kernel connects::kernel connects
device drivers::device drivers
basic level::basic level
hardware devices::hardware devices
manages memory::manages memory
memory access::memory access
hardware resources::hardware resources
operating states::operating states
optimal operation::optimal operation
term non::term non
volatile storage::volatile storage
file systems::file systems
flash memory::flash memory
program execution::program execution
application program::application program
obeying rules::obeying rules
procedures programmed::procedures programmed
simplify development::simplify development
programs executing::programs executing
program involves::program involves
system kernel::system kernel
assigns memory::assigns memory
memory space::memory space
tasking systems::tasking systems
loads program::loads program
program binary::program binary
binary code::binary code
initiates execution::initiates execution
devices interrupts::devices interrupts
interrupt interrupts::interrupt interrupts
require action::require action
older systems::older systems
small stacks::small stacks
modern systems::modern systems
large stacks::large stacks
stacks interrupt::stacks interrupt
interrupt based::interrupt based
based programming::based programming
modern cpus::modern cpus
cpus interrupts::cpus interrupts
interrupts provide::interrupts provide
local register::local register
register contexts::register contexts
specific code::specific code
basic computers::basic computers
computers support::computers support
support hardware::support hardware
hardware interrupts::hardware interrupts
event takes::event takes
takes place::takes place
runs computer::runs computer
phone call::phone call
kernel interrupts::kernel interrupts
running program::running program
hardware device::hardware device
device triggers::device triggers
kernel decides::kernel decides
processing code::processing code
run depends::run depends
smoke detector::smoke detector
detector alarm::detector alarm
device driver::device driver
relay information::relay information
program wishes::program wishes
access hardware::access hardware
additional resources::additional resources
shed resources::shed resources
attention modes::attention modes
protected mode::protected mode
supervisor mode::supervisor mode
mode modern::mode modern
cpus support::cpus support
support multiple::support multiple
multiple modes::multiple modes
operation cpus::operation cpus
low level::low level
level tasks::level tasks
unrestricted access::unrestricted access
graphics cards::graphics cards
cards protected::cards protected
applications operate::applications operate
mode cpus::mode cpus
virtual modes::virtual modes
older processor::older processor
processor types::processor types
bit processors::bit processors
unlimited access::unlimited access
protected environment::protected environment
system passes::system passes
passes control::passes control
limited set::limited set
user program::user program
causing control::causing control
exclusive control::exclusive control
mode resource::mode resource
generally refers::generally refers
cpu registers::cpu registers
alter attempts::alter attempts
illegal operation::illegal operation
memory management::memory management
multiprogramming operating::multiprogramming operating
system memory::system memory
independent access::independent access
cooperative memory::cooperative memory
early operating::early operating
programs make::programs make
memory manager::memory manager
allocated memory::allocated memory
program fails::program fails
malicious programs::malicious programs
misbehaved program::misbehaved program
memory protection::memory protection
protection enables::protection enables
protection exist::protection exist
including memory::including memory
memory segmentation::memory segmentation
methods require::methods require
hardware support::hardware support
mode registers::mode registers
memory address::memory address
access attempts::access attempts
enter supervisor::enter supervisor
asegmentation violation::asegmentation violation
meaningful result::meaningful result
misbehaving program::misbehaving program
offending program::offending program
error windows::error windows
windows versions::windows versions
general protection::general protection
segmentation violation::segmentation violation
virtual memory::virtual memory
page fault::page fault
memory addressing::memory addressing
memory locations::memory locations
multiple tasks::multiple tasks
access memory::access memory
current range::current range
accessible memory::accessible memory
kernel detects::kernel detects
memory range::memory range
memory requested::memory requested
kernel discretionary::kernel discretionary
discretionary power::discretionary power
memory area::memory area
larger amount::larger amount
computer multitasking::computer multitasking
process management::process management
context switch::context switch
preemptive multitasking::preemptive multitasking
multitasking multitasking::multitasking multitasking
multitasking refers::multitasking refers
multiple independent::multiple independent
independent computer::independent computer
scheduling program::scheduling program
process spends::process spends
spends executing::spends executing
order execution::order execution
execution control::execution control
programs control::programs control
program access::program access
early model::early model
returning control::returning control
malfunctioning program::malfunctioning program
entire system::entire system
infinite loop::infinite loop
loop modern::loop modern
systems extend::systems extend
application preemption::application preemption
preemptive control::preemptive control
internal run::internal run
run times::run times
philosophy governing::philosophy governing
system kernels::system kernels
kernels make::kernels make
timed interrupt::timed interrupt
mode timer::mode timer
dual mode::dual mode
mode operation::mode operation
systems cooperative::systems cooperative
home computers::home computers
small number::small number
tested programs::tested programs
home user::home user
user market::user market
disk access::disk access
virtual file::virtual file
file system::file system
system access::system access
data stored::data stored
central feature::central feature
systems computers::systems computers
computers store::computers store
store data::store data
disks usingfiles::disks usingfiles
specific ways::specific ways
faster access::faster access
higher reliability::higher reliability
enables files::enables files
folders arranged::folders arranged
directory tree::directory tree
single type::single type
file names::file names
directory structures::directory structures
reflected limitations::reflected limitations
simpler operating::simpler operating
systems support::systems support
limited range::limited range
accessing storage::accessing storage
storage systems::storage systems
linux support::linux support
unix supports::unix supports
wide array::wide array
storage devices::storage devices
common application::common application
application programming::application programming
programming interface::programming interface
provide programs::provide programs
unlimited number::unlimited number
infinite variety::infinite variety
systems installed::systems installed
specific device::specific device
system drivers::system drivers
connected storage::connected storage
storage device::storage device
hard drive::hard drive
driver understands::driver understands
specific language::specific language
standard language::standard language
disk drives::disk drives
block devices::block devices
disk drive::disk drive
raw format::raw format
system driver::system driver
specific file::specific file
standard set::standard set
systems programs::systems programs
hierarchical structure::hierarchical structure
close files::close files
including access::including access
access permissions::access permissions
free space::free space
modification dates::modification dates
systems make::systems make
systems difficult::systems difficult
difficult allowed::difficult allowed
allowed characters::allowed characters
case sensitivity::case sensitivity
file attributes::file attributes
attributes makes::attributes makes
single interface::single interface
daunting task::daunting task
task operating::task operating
systems tend::systems tend
party drives::party drives
give support::give support
purpose operating::purpose operating
party software::party software
common file::common file
include support::include support
system support::system support
disk formats::disk formats
windows vista::windows vista
install linux::install linux
usb flash::usb flash
flash drive::flash drive
file located::file located
system device::system device
specific type::specific type
computer software::computer software
software developed::software developed
specific computer::specific computer
computer bus::computer bus
communications subsystem::communications subsystem
providing commands::providing commands
receiving data::receiving data
requisite interfaces::requisite interfaces
software applications::software applications
specialized hardware::specialized hardware
hardware dependent::hardware dependent
dependent computer::dependent computer
computer program::computer program
system specific::system specific
applications software::applications software
software package::software package
program running::program running
requisite interrupt::requisite interrupt
interrupt handling::interrupt handling
dependent hardware::dependent hardware
hardware interfacing::hardware interfacing
key design::key design
design goal::design goal
newer models::newer models
controlled differently::controlled differently
differently computers::differently computers
system mandated::system mandated
mandated function::mandated function
function calls::function calls
specific calls::specific calls
suitable driver::suitable driver
driver ensures::driver ensures
device appears::device appears
driver execution::driver execution
driver entered::driver entered
recent revisions::recent revisions
systems incorporate::systems incorporate
incorporate kernel::incorporate kernel
kernel preemption::kernel preemption
computer network::computer network
networking protocols::networking protocols
dissimilar operating::dissimilar operating
common network::common network
sharing resources::sharing resources
wireless connections::wireless connections
connections networks::connections networks
remote computer::remote computer
local computer::local computer
simple communication::simple communication
networked file::networked file
sound hardware::sound hardware
networked users::networked users
direct access::direct access
server servers::server servers
servers offer::servers offer
network computers::network computers
numbered access::numbered access
access points::access points
serversnetwork address::serversnetwork address
port number::port number
handling requests::handling requests
turn access::turn access
local hardware::local hardware
passing requests::passing requests
open networking::open networking
microsoft specific::microsoft specific
specific protocols::specific protocols
specific tasks::specific tasks
file access::file access
access protocols::access protocols
remote system::remote system
hardware security::hardware security
computer security::computer security
secure depends::secure depends
technologies working::technologies working
working properly::working properly
software running::software running
external devices::external devices
non privileged::non privileged
requester identity::requester identity
establish identity::establish identity
magnetic cards::magnetic cards
biometric data::biometric data
reading files::reading files
network share::network share
identity isauthorization::identity isauthorization
user account::user account
configured groups::configured groups
requester belongs::requester belongs
disallow model::disallow model
auditing options::auditing options
internal security::internal security
harmful requests::harmful requests
directly access::directly access
external security::external security
security involves::security involves
connected console::connected console
network connection::network connection
external requests::external requests
out directly::out directly
directly security::directly security
sensitive data::sensitive data
data held::data held
military nature::military nature
united statesgovernment::united statesgovernment
statesgovernment department::statesgovernment department
trusted computer::trusted computer
system evaluation::system evaluation
evaluation criteria::evaluation criteria
basic requirements::basic requirements
vital importance::vital importance
system makers::system makers
trusted operating::trusted operating
classified information::classified information
information network::information network
services include::services include
include offerings::include offerings
file sharing::file sharing
print services::print services
web sites::web sites
file transfer::file transfer
transfer protocols::transfer protocols
compromised security::compromised security
front line::front line
system level::system level
software firewalls::software firewalls
software firewall::software firewall
deny network::deny network
network traffic::network traffic
application running::application running
insecure service::insecure service
security breach::security breach
alternative strategy::alternative strategy
sandbox strategy::sandbox strategy
goldberg virtualization::goldberg virtualization
virtualization requirements::virtualization requirements
running user::running user
user programs::user programs
native code::native code
code based::code based
based system::based system
user systems::user systems
private files::private files
bypassing auditing::bypassing auditing
auditing user::auditing user
system user::system user
individual requires::individual requires
human interaction::human interaction
interface views::interface views
views thedirectory::views thedirectory
thedirectory structure::thedirectory structure
requests services::requests services
acquire data::acquire data
input hardware::input hardware
card reader::card reader
requests operating::requests operating
system services::system services
status messages::status messages
output hardware::output hardware
video monitor::video monitor
common forms::common forms
computer commands::computer commands
out line::out line
visual environment::visual environment
user interfaces::user interfaces
modern computer::modern computer
original implementation::original implementation
system service::system service
incorporating support::incorporating support
context switches::context switches
switches required::switches required
output functions::output functions
graphics subsystem::graphics subsystem
modern releases::modern releases
vista implement::vista implement
user space::user space
graphics drawing::graphics drawing
drawing routines::drawing routines
kernel space::kernel space
space windows::space windows
computer operating::computer operating
window system::window system
kde plasma::kde plasma
plasma desktop::plasma desktop
found setup::found setup
number ofwindows::number ofwindows
ofwindows shell::ofwindows shell
shell replacements::shell replacements
offer alternatives::offer alternatives
included windows::included windows
windows shell::windows shell
numerous unix::numerous unix
unix based::unix based
based guis::based guis
x11 competition::x11 competition
widespread adoption::widespread adoption
desktop environment::desktop environment
software based::software based
based toolkits::based toolkits
desktop environments::desktop environments
interfaces evolve::interfaces evolve
major version::major version
gui changed::gui changed
system intended::system intended
fixed deadlines::fixed deadlines
applications include::applications include
automobile engine::automobile engine
engine controllers::engine controllers
industrial robots::industrial robots
industrial control::industrial control
scale computing::scale computing
computing systems::computing systems
transaction processing::transaction processing
processing facility::processing facility
facility developed::facility developed
american airlines::american airlines
sabre airline::sabre airline
airline reservations::airline reservations
reservations system::reservations system
system embedded::system embedded
montavista linux::montavista linux
shares similar::shares similar
similar apis::similar apis
desktop windows::desktop windows
codebase symbian::codebase symbian
rtos kernel::rtos kernel
computing operating::computing operating
system development::system development
hobbyist operating::hobbyist operating
development operating::development operating
complicated activities::complicated activities
computing hobbyist::computing hobbyist
hobby operating::hobby operating
existing operating::existing operating
active developers::active developers
hobby development::hobby development
computing device::computing device
simple single::simple single
single board::single board
board computer::board computer
computer powered::computer powered
unstructured group::unstructured group
interests examples::interests examples
system include::system include
include reactos::include reactos
syllable diversity::syllable diversity
portability application::portability application
specific operating::specific operating
specific hardware::specific hardware
functionality required::functionality required
maintained unix::maintained unix
first operating::first operating
native pdp::native pdp
supporting operating::supporting operating
systems diversity::systems diversity
writing applications::writing applications
software platforms::software platforms
system libraries::system libraries
system vendors::system vendors
adopt standards::adopt standards
abstraction layers::abstraction layers
layers provide::layers provide
provide commonalities::provide commonalities
operating::operating
system::system
software::software
manages::manages
computer::computer
hardware::hardware
resources::resources
common::common
services::services
programs::programs
essential::essential
component::component
application::application
require::require
function::function
sharing::sharing
systems::systems
schedule::schedule
tasks::tasks
efficient::efficient
include::include
accounting::accounting
cost::cost
allocation::allocation
processor::processor
mass::mass
storage::storage
printing::printing
functions::functions
input::input
output::output
memory::memory
acts::acts
intermediary::intermediary
code::code
executed::executed
directly::directly
frequently::frequently
makes::makes
calls::calls
interrupted::interrupted
found::found
devices::devices
cellular::cellular
phones::phones
video::video
game::game
consoles::consoles
web::web
servers::servers
supercomputers::supercomputers
examples::examples
popular::popular
modern::modern
android::android
blackberry::blackberry
bsd::bsd
chrome::chrome
ios::ios
linux::linux
qnx::qnx
microsoft::microsoft
windows::windows
phone::phone
z::NNP
first::first
share::share
roots::roots
unix::unix
types::types
single::single
multi::multi
tasking::tasking
run::run
program::program
running::running
concurrency::concurrency
achieved::achieved
dividing::dividing
multiple::multiple
processes::processes
repeatedly::repeatedly
slices::slices
task::task
scheduling::scheduling
subsystem::subsystem
characterized::characterized
pre::pre
emptive::emptive
operative::operative
multitasking::multitasking
cpu::cpu
dedicates::dedicates
slot::slot
e.g::e.g
solaris::solaris
asamigaos::asamigaos
support::support
cooperative::cooperative
relying::relying
process::process
provide::provide
defined::defined
manner::manner
bit::bit
versions::versions
win9x::win9x
user::user
facilities::facilities
distinguish::distinguish
users::users
tandem::tandem
extends::extends
basic::basic
concept::concept
identify::identify
disk::disk
space::space
belonging::belonging
permits::permits
interact::interact
distributed::distributed
group::group
distinct::distinct
computers::computers
development::development
networked::networked
linked::linked
communicate::communicate
gave::gave
rise::rise
computing::computing
computations::computations
carried::carried
out::out
machine::machine
work::work
cooperation::cooperation
form::form
templated::templated
cloud::cloud
context::context
templating::templating
refers::refers
creating::creating
virtual::virtual
image::image
guest::guest
saving::saving
tool::tool
machines::machines
gagne::gagne
technique::technique
virtualization::virtualization
management::management
large::large
server::server
warehouses::warehouses
embedded::embedded
designed::designed
operate::operate
small::small
pdas::pdas
autonomy::autonomy
limited::limited
number::number
compact::compact
extremely::extremely
design::design
minix::minix
real::real
guaranties::guaranties
events::events
data::data
short::short
amount::amount
specialized::specialized
algorithms::algorithms
deterministic::deterministic
nature::nature
behavior::behavior
event::event
driven::driven
switches::switches
based::based
priorities::priorities
external::external
switch::switch
clock::clock
interrupts::interrupts
history::history
resident::resident
monitor::monitor
early::early
built::built
perform::perform
series::series
calculator::calculator
features::features
developed::developed
1950s::1950s
automatically::automatically
succession::succession
speed::speed
processing::processing
exist::exist
complex::complex
forms::forms
1960s::1960s
added::added
enabled::enabled
runtime::runtime
libraries::libraries
parallel::parallel
whenpersonal::whenpersonal
1980s::1980s
made::made
similar::similar
larger::larger
1940s::1940s
earliest::earliest
electronic::electronic
digital::digital
programmed::programmed
rows::rows
mechanical::mechanical
jumper::jumper
wires::wires
plug::plug
boards::boards
special::special
purpose::purpose
generated::generated
ballistics::ballistics
tables::tables
military::military
controlled::controlled
payroll::payroll
checks::checks
punched::punched
paper::paper
cards::cards
programmable::programmable
general::general
invented::invented
languages::languages
consisting::consisting
strings::strings
binary::binary
digits::digits
tape::tape
introduced::introduced
sped::sped
programming::programming
stern::stern
execute::execute
sole::sole
period::period
arrive::arrive
scheduled::scheduled
loaded::loaded
set::set
completed::completed
crashed::crashed
generally::generally
debugged::debugged
front::front
panel::panel
toggle::toggle
lights::lights
alan::alan
turing::turing
master::master
manchester::manchester
mark::mark
deriving::deriving
primitive::primitive
conception::conception
principles::principles
universal::universal
assist::assist
operations::operations
generating::generating
human::human
readable::readable
symbolic::symbolic
genesis::genesis
day::day
ran::ran
job::job
cambridge::cambridge
university::university
england::england
queue::queue
washing::washing
line::line
tapes::tapes
hung::hung
colored::colored
clothes::clothes
pegs::pegs
priority::priority
improvement::improvement
atlas::atlas
supervisor::supervisor
commissioned::commissioned
considered::considered
recognisable::recognisable
brinch::brinch
hansen::hansen
described::described
significant::significant
breakthrough::breakthrough
mainframes::mainframes
mainframe::mainframe
ibm::ibm
major::major
pioneered::pioneered
field::field
including::including
batch::batch
interrupt::interrupt
buffering,multitasking::buffering,multitasking
spooling::spooling
link::link
loading::loading
sorting::sorting
records::records
files::files
included::included
option::option
programmers::programmers
separate::separate
applications::applications
systemwas::systemwas
released::released
integrated::integrated
utility::utility
quickly::quickly
supplanted::supplanted
os::-NONE-
spanning::spanning
entire::entire
product::product
crucial::crucial
success::success
current::current
distant::distant
descendants::descendants
original::original
written::written
track::track
main::main
file::file
secondary::secondary
locking::locking
update::update
terminated::terminated
reason::reason
claimed::claimed
alternative::alternative
started::started
focused::focused
compatibility::compatibility
acp::acp
airline::airline
control::control
non::non
mts::mts
michigan::michigan
terminal::terminal
music::music
interactive::interactive
orvyl::orvyl
stanford::stanford
timesharing::timesharing
corporation::corporation
scope::scope
minnesota::minnesota
thekronos::thekronos
nos::nos
1970s::1970s
supported::supported
simultaneous::simultaneous
commercial::commercial
interface::interface
extension::extension
dartmouth::dartmouth
pioneering::pioneering
efforts::efforts
late::late
illinois::illinois
plato::plato
plasma::plasma
displays::displays
long::long
distance::distance
networks::networks
remarkably::remarkably
innovative::innovative
featuring::featuring
chat::chat
graphical::graphical
games::games
burroughs::burroughs
b5000::b5000
mcp::mcp
stack::stack
exclusively::exclusively
high::high
level::level
language::language
assembler::assembler
espol::espol
dialect::dialect
algol::algol
ground::ground
breaking::breaking
innovations::innovations
implementation::implementation
ofvirtual::ofvirtual
as400::as400
approach::approach
licence::licence
proposal::proposal
declined::declined
protect::protect
existing::existing
production::production
today::today
unisys::unisys
univac::univac
manufacturer::manufacturer
produced::produced
exec::exec
frame::frame
oriented::oriented
managed::managed
magnetic::magnetic
drums::drums
disks::disks
card::card
readers::readers
printers::printers
rtb::rtb
scale::scale
patterned::patterned
electric::electric
mit::mit
comprehensive::comprehensive
gecos::gecos
ringed::ringed
security::security
privilege::privilege
levels::levels
acquisition::acquisition
honeywell::honeywell
renamed::renamed
gcos::gcos
equipment::equipment
lines::lines
tops::tops
pdp::pdp
class::class
widespread::widespread
universities::universities
arpanetcommunity::arpanetcommunity
capabilities::capabilities
evolved::evolved
allowed::allowed
ported::ported
utilized::utilized
microprogramming::microprogramming
implement::implement
order::order
permit::permit
underlying::underlying
architectures::architectures
fact::fact
360s::360s
microprogrammed::microprogrammed
implementations::implementations
enormous::enormous
investment::investment
caused::caused
manufacturers::manufacturers
continue::continue
develop::develop
compatible::compatible
notable::notable
present::present
z::NNS
clearpath::clearpath
dorado::dorado
microcomputers::microcomputers
dos::dos
personal::personal
featured::featured
command::command
mac::mac
apple::apple
feature::feature
icons::icons
commonplace::commonplace
guis::guis
capacity::capacity
elaborate::elaborate
minis::minis
minimalistic::minimalistic
romand::romand
monitors::monitors
closely::closely
imitated::imitated
widely::widely
chosen::chosen
version::version
80s::80s
abandoned::abandoned
introduce::introduce
macintoshcomputer::macintoshcomputer
gui::gui
introduction::introduction
intel::intel
chip::chip
architecture::architecture
paging::paging
provided::provided
ability::ability
earlier::earlier
minicomputers::minicomputers
andmainframes::andmainframes
responded::responded
progress::progress
hiring::hiring
dave::dave
cutler::cutler
vms::vms
lead::lead
continues::continues
serve::serve
basis::basis
steve::steve
jobs::jobs
founder::founder
nextstep::nextstep
acquired::acquired
freebsd::freebsd
core::core
gnu::gnu
project::project
activist::activist
programmer::programmer
richard::richard
stallman::stallman
goal::goal
completefree::completefree
replacement::replacement
proprietary::proprietary
highly::highly
successful::successful
duplicating::duplicating
functionality::functionality
parts::parts
hurd::hurd
kernel::kernel
proved::proved
unproductive::unproductive
finnish::finnish
science::science
student::student
linus::linus
torvalds::torvalds
volunteers::volunteers
collaborating::collaborating
internet::internet
merged::merged
gnuuser::gnuuser
components::components
complete::complete
combination::combination
two::two
referred::referred
simply::simply
industry::industry
naming::naming
convention::convention
free::free
foundation::foundation
remain::remain
opposed::opposed
preferring::preferring
berkeley::berkeley
distribution::distribution
derivative::derivative
california::california
starting::starting
freely::freely
eventually::eventually
gained::gained
pcs::pcs
netbsd::netbsd
openbsd::openbsd
evolution::evolution
originally::originally
assembly::assembly
ken::ken
thompson::thompson
wrote::wrote
bcpl::bcpl
experience::experience
multics::multics
replaced::replaced
rewritten::rewritten
family::family
inter::inter
related::related
influential::influential
diverse::diverse
sub::sub
categories::categories
trademark::trademark
open::open
licenses::licenses
shown::shown
conform::conform
definitions::definitions
commonly::commonly
resemble::resemble
wide::wide
variety::variety
heavily::heavily
business::business
workstations::workstations
academic::academic
engineering::engineering
environments::environments
variants::variants
areas::areas
four::four
certified::certified
holder::holder
aix::aix
respective::respective
vendor::vendor
contrast::contrast
sun::sun
microsystems::microsystems
x86::x86
sparc::sparc
hybrid::hybrid
variant::variant
derived::derived
mach::mach
interoperability::interoperability
sought::sought
establishing::establishing
posix::posix
standard::standard
applied::applied
created::created
subgroup::subgroup
includes::includes
andopenbsd::andopenbsd
webservers::webservers
owes::owes
existence::existence
protocols::protocols
connect::connect
send::send
receive::receive
network::network
implemented::implemented
refined::refined
world::world
demonstrated::demonstrated
installed::installed
students::students
staff::staff
department::department
began::began
adding::adding
make::make
things::things
easier::easier
text::text
ors::ors
received::received
vax::vax
school::school
undergraduates::undergraduates
modified::modified
advantage::advantage
possibilities::possibilities
defense::defense
advanced::advanced
research::research
projects::projects
agency::agency
interest::interest
decided::decided
fund::fund
schools::schools
corporations::corporations
government::government
organizations::organizations
notice::notice
official::official
at&t::at&t
leaving::leaving
formed::formed
company::company
manufactured::manufactured
end::end
variation::variation
callednextstep::callednextstep
tim::tim
berners::berners
lee::lee
webserver::webserver
create::create
developers::developers
keith::keith
bostic::bostic
encouraged::encouraged
replace::replace
originated::originated
bell::bell
labs::labs
done::done
sued::sued
years::years
legal::legal
disputes::disputes
spawned::spawned
derivatives::derivatives
marketed::marketed
sold::sold
byapple::byapple
latest::latest
shipping::shipping
macintosh::macintosh
successor::successor
primary::primary
unlike::unlike
predecessor::predecessor
technology::technology
half::half
purchased::purchased
desktop::desktop
v10.0::v10.0
cheetah::cheetah
march::march
client::client
ions::ions
lion::lion
releases::releases
v10.8::v10.8
named::named
big::big
cats::cats
v10.9::v10.9
mavericks::mavericks
inspirational::inspirational
places::places
yosemite::yosemite
recent::recent
announced::announced
june::june
wwdc::wwdc
prior::prior
merging::merging
ion::ion
architecturally::architecturally
identical::identical
counterpart::counterpart
administration::administration
tools::tools
simplified::simplified
access::access
key::key
mail::mail
transfer::transfer
agent::agent
samba::samba
ldap::ldap
domain::domain
v10.7::v10.7
aspects::aspects
branded::branded
dropping::dropping
offered::offered
mobile::mobile
side::side
finland::finland
posted::posted
information::information
newsgroup::newsgroup
assistance::assistance
succeeded::succeeded
functional::functional
license::license
model::model
study::study
modification::modification
resulted::resulted
range::range
machinery::machinery
smart::smart
watches::watches
estimates::estimates
suggest::suggest
adopted::adopted
cell::cell
superseded::superseded
platforms::platforms
ten::ten
powerful::powerful
distributions::distributions
red::red
hat::hat
debian::debian
ubuntu::ubuntu
mint::mint
google::google
chromium::chromium
targets::targets
spend::spend
browser::browser
local::local
manager::manager
media::media
player::player
relies::relies
apps::apps
accomplish::accomplish
word::word
differs::differs
source::source
primarily::primarily
shipped::shipped
chromebooks::chromebooks
targeted::targeted
estimated::estimated
percent::percent
total::total
usage::usage
connected::connected
newest::newest
recently::recently
overtook::overtook
environment::environment
top::top
bootstrap::bootstrap
backwards::backwards
mode::mode
bits::bits
3.x::3.x
drivers::drivers
last::last
arm::arm
microprocessors::microprocessors
additionitanium::additionitanium
older::older
past::past
additional::additional
expended::expended
capital::capital
effort::effort
promote::promote
competes::competes
market::market
longer::longer
amigaos::amigaos
precursor::precursor
beos::beos
xts::xts
risc::risc
morphos::morphos
haiku::haiku
baremetal::baremetal
freemint::freemint
niche::niche
markets::markets
minority::minority
enthusiast::enthusiast
communities::communities
specialist::specialist
openvms::openvms
dec::dec
active::active
hewlett::hewlett
packard::packard
academia::academia
education::education
concepts::concepts
typical::typical
fulfills::fulfills
roles::roles
singularity::singularity
purely::purely
failed::failed
win::win
influenced::influenced
mainstream::mainstream
plan::plan
simple::simple
mouse::mouse
keyboard::keyboard
connects::connects
aid::aid
firmware::firmware
device::device
ram::ram
determines::determines
sets::sets
resets::resets
states::states
optimal::optimal
operation::operation
times::times
organizes::organizes
term::term
volatile::volatile
flash::flash
execution::execution
obeying::obeying
rules::rules
procedures::procedures
simplify::simplify
executing::executing
involves::involves
creation::creation
assigns::assigns
establishes::establishes
loads::loads
initiates::initiates
interacts::interacts
central::central
react::react
watch::watch
sources::sources
polling::polling
action::action
stacks::stacks
bytes::bytes
unusual::unusual
cpus::cpus
register::register
contexts::contexts
specific::specific
response::response
takes::takes
place::place
suspends::suspends
saves::saves
status::status
runs::runs
previously::previously
analogous::analogous
placing::placing
bookmark::bookmark
book::book
call::call
handled::handled
triggers::triggers
decides::decides
deal::deal
depends::depends
person::person
responds::responds
smoke::smoke
detector::detector
alarm::alarm
answering::answering
delegated::delegated
driver::driver
part::part
relay::relay
means::means
trigger::trigger
wishes::wishes
passed::passed
back::back
request::request
shed::shed
attention::attention
modes::modes
protected::protected
capability::capability
low::low
unrestricted::unrestricted
controlling::controlling
erased::erased
communication::communication
graphics::graphics
communicating::communicating
controls::controls
emulate::emulate
processors::processors
starts::starts
bios::bios
efi::efi
bootloader::bootloader
unlimited::unlimited
required::required
definition::definition
initializing::initializing
passes::passes
instructions::instructions
leave::leave
triggering::triggering
causing::causing
maintain::maintain
exclusive::exclusive
resource::resource
registers::registers
nt::nt
alter::alter
attempts::attempts
illegal::illegal
attempting::attempting
killing::killing
multiprogramming::multiprogramming
responsible::responsible
managing::managing
ensures::ensures
interfere::interfere
independent::independent
assumes::assumes
voluntary::voluntary
exceed::exceed
allocated::allocated
bugs::bugs
fails::fails
affected::affected
overwritten::overwritten
malicious::malicious
viruses::viruses
affect::affect
misbehaved::misbehaved
crash::crash
protection::protection
enables::enables
limit::limit
methods::methods
segmentation::segmentation
mmu::mmu
address::address
addresses::addresses
enter::enter
charge::charge
asegmentation::asegmentation
violation::violation
seg::seg
difficult::difficult
assign::assign
meaningful::meaningful
result::result
sign::sign
misbehaving::misbehaving
resorts::resorts
terminating::terminating
offending::offending
reports::reports
error::error
easily::easily
circumvent::circumvent
faultwould::faultwould
indicating::indicating
occurred::occurred
page::page
fault::fault
addressing::addressing
choose::choose
allowing::allowing
locations::locations
accessible::accessible
nonetheless::nonetheless
section::section
kind::kind
detects::detects
adjusts::adjusts
triggered::triggered
granting::granting
requested::requested
discretionary::discretionary
power::power
stored::stored
accessed::accessed
temporarily::temporarily
swapping::swapping
area::area
swapped::swapped
exchanged::exchanged
demand::demand
perception::perception
preemptive::preemptive
giving::giving
appearance::appearance
performing::performing
spends::spends
returned::returned
mechanism::mechanism
passing::passing
governed::governed
explicitly::explicitly
returning::returning
malfunctioning::malfunctioning
prevent::prevent
hang::hang
enters::enters
infinite::infinite
loop::loop
extend::extend
preemption::preemption
internal::internal
philosophy::philosophy
governing::governing
ensuring::ensuring
regular::regular
implies::implies
kernels::kernels
timed::timed
timer::timer
return::return
elapsed::elapsed
sections::sections
dual::dual
perfectly::perfectly
adequate::adequate
home::home
tested::tested
exception::exception
windowswhich::windowswhich
enforced::enforced
reach::reach
professionals::professionals
store::store
usingfiles::usingfiles
structured::structured
ways::ways
faster::faster
higher::higher
reliability::reliability
drive::drive
names::names
attributes::attributes
hierarchy::hierarchy
directories::directories
folders::folders
arranged::arranged
directory::directory
tree::tree
type::type
kinds::kinds
structures::structures
limitations::limitations
reflected::reflected
making::making
simpler::simpler
options::options
accessing::accessing
vfs::vfs
supports::supports
array::array
api::api
unnecessary::unnecessary
knowledge::knowledge
hard::hard
understands::understands
translate::translate
drives::drives
block::block
contents::contents
raw::raw
format::format
commands::commands
talk::talk
filenames::filenames
contained::contained
hierarchical::hierarchical
structure::structure
delete::delete
close::close
gather::gather
permissions::permissions
size::size
dates::dates
differences::differences
supporting::supporting
characters::characters
case::case
sensitivity::sensitivity
presence::presence
daunting::daunting
tend::tend
recommend::recommend
natively::natively
specifically::specifically
ntfs::ntfs
ext3::ext3
reiserfs::reiserfs
practice::practice
party::party
give::give
varied::varied
vary::vary
formats::formats
cds::cds
iso::iso
udf::udf
vista::vista
install::install
disc::disc
dvd::dvd
usb::usb
located::located
interaction::interaction
typically::typically
constitutes::constitutes
bus::bus
communications::communications
providing::providing
receiving::receiving
requisite::requisite
interfaces::interfaces
dependent::dependent
package::package
transparently::transparently
handling::handling
asynchronous::asynchronous
interfacing::interfacing
abstraction::abstraction
newer::newer
models::models
reliable::reliable
performance::performance
differently::differently
expected::expected
future::future
solve::solve
problem::problem
essentially::essentially
dictate::dictate
mandated::mandated
theory::theory
correctly::correctly
suitable::suitable
appears::appears
usual::usual
point::point
view::view
meaning::meaning
entered::entered
freeze::freeze
revisions::revisions
incorporate::incorporate
separates::separates
receives::receives
networking::networking
dissimilar::dissimilar
participate::participate
scanners::scanners
wired::wired
wireless::wireless
connections::connections
remote::remote
sound::sound
ssh::ssh
direct::direct
offer::offer
host::host
ports::ports
numbered::numbered
points::points
serversnetwork::serversnetwork
port::port
maximum::maximum
requests::requests
daemon::daemon
turn::turn
sna::sna
decnet::decnet
smb::smb
asnfs::asnfs
esound::esound
esd::esd
extended::extended
secure::secure
technologies::technologies
working::working
properly::properly
capable::capable
distinguishing::distinguishing
processed::processed
privileged::privileged
requester::requester
identity::identity
establish::establish
authentication::authentication
username::username
quoted::quoted
password::password
biometric::biometric
cases::cases
reading::reading
covered::covered
isauthorization::isauthorization
logged::logged
tied::tied
account::account
variously::variously
configured::configured
groups::groups
belongs::belongs
addition::addition
disallow::disallow
offers::offers
auditing::auditing
tracking::tracking
possibly::possibly
harmful::harmful
secured::secured
login::login
console::console
connection::connection
concern::concern
sensitive::sensitive
held::held
united::united
statesgovernment::statesgovernment
dod::dod
trusted::trusted
evaluation::evaluation
criteria::criteria
tcsec::tcsec
requirements::requirements
assessing::assessing
effectiveness::effectiveness
vital::vital
importance::importance
makers::makers
evaluate::evaluate
classify::classify
select::select
retrieval::retrieval
classified::classified
offerings::offerings
print::print
email::email
sites::sites
ftp::ftp
compromised::compromised
firewalls::firewalls
intrusion::intrusion
firewall::firewall
default::default
deny::deny
traffic::traffic
service::service
insecure::insecure
telnet::telnet
threatened::threatened
breach::breach
strategy::strategy
sandbox::sandbox
meet::meet
popek::popek
goldberg::goldberg
native::native
emulates::emulates
java::java
relevant::relevant
private::private
tamper::tamper
read::read
potentially::potentially
bypass::bypass
inclusive::inclusive
bypassing::bypassing
operated::operated
individual::individual
requires::requires
shell::shell
views::views
thedirectory::thedirectory
acquire::acquire
reader::reader
displayprompts::displayprompts
messages::messages
printer::printer
historically::historically
typed::typed
visual::visual
wimp::wimp
technically::technically
incorporating::incorporating
responsive::responsive
reducing::reducing
modular::modular
separating::separating
drawing::drawing
routines::routines
distinction::distinction
desire::desire
window::window
conjunction::conjunction
gnome::gnome
kde::kde
setup::setup
ofwindows::ofwindows
replacements::replacements
alternatives::alternatives
separated::separated
numerous::numerous
existed::existed
x11::x11
competition::competition
vendors::vendors
led::led
fragmentation::fragmentation
standardize::standardize
1990s::1990s
cose::cose
cde::cde
reasons::reasons
eclipsed::eclipsed
adoption::adoption
toolkits::toolkits
motif::motif
prevalent::prevalent
evolve::evolve
changed::changed
dramatically::dramatically
rtos::rtos
intended::intended
fixed::fixed
deadlines::deadlines
automobile::automobile
engine::engine
controllers::controllers
industrial::industrial
robots::robots
spacecraft::spacecraft
transaction::transaction
facility::facility
american::american
airlines::airlines
sabre::sabre
reservations::reservations
vxworks::vxworks
pikeos::pikeos
ecos::ecos
montavista::montavista
rtlinux.windows::rtlinux.windows
shares::shares
apis::apis
codebase::codebase
symbian::symbian
eka2::eka2
8.0b::8.0b
palm::palm
hobby::hobby
hobbyist::hobbyist
complicated::complicated
activities::activities
engage::engage
homebrew::homebrew
board::board
powered::powered
microprocessor::microprocessor
commence::commence
modeling::modeling
developer::developer
unstructured::unstructured
individuals::individuals
interests::interests
reactos::reactos
syllable::syllable
diversity::diversity
portability::portability
porting::porting
arguments::arguments
requiring::requiring
adapted::adapted
maintained::maintained
portable::portable
avoided::avoided
writing::writing
abstractions::abstractions
borne::borne
adaptation::adaptation
adopt::adopt
standards::standards
layers::layers
commonalities::commonalities
reduce::reduce
