intermediary between users::intermediary between users
users and computer::users and computer
users an environment::users an environment
user can execute::user can execute
conveniently and efficiently::conveniently and efficiently
efficiently in technical::efficiently in technical
software which manages::software which manages
hardware an operating::hardware an operating
operating system controls::operating system controls
controls the allocation::controls the allocation
allocation of resources::allocation of resources
resources and services::resources and services
devices and information::devices and information
definition an operating::definition an operating
program that acts::program that acts
hardware and controls::hardware and controls
controls the execution::controls the execution
kinds of programs::kinds of programs
system * memory::system * memory
management * processor::management * processor
management * device::management * device
management * file::management * file
management * security::management * security
security * control::security * control
control over system::control over system
performance * job::performance * job
accounting * error::accounting * error
error detecting aids::error detecting aids
aids * coordination::aids * coordination
software and users::software and users
users memory management::users memory management
memory management memory::memory management memory
management memory management::management memory management
memory management refers::memory management refers
refers to management::refers to management
management of primary::management of primary
memory or main::memory or main
main memory main::main memory main
memory main memory::memory main memory
array of words::array of words
words or bytes::words or bytes
word or byte::word or byte
address main memory::address main memory
main memory operating::main memory operating
memory operating system::memory operating system
activities for memory::activities for memory
tracks of primary::tracks of primary
primary memory i.e::primary memory i.e
i.e what part::i.e what part
decides which process::decides which process
allocates the memory::allocates the memory
de-allocates the memory::de-allocates the memory
process no longer::process no longer
terminated processor management::terminated processor management
management in multiprogramming::management in multiprogramming
process scheduling operating::process scheduling operating
scheduling operating system::scheduling operating system
activities for processor::activities for processor
tracks of processor::tracks of processor
processor and status::processor and status
status of process::status of process
process program responsible::process program responsible
controller * allocates::controller * allocates
allocates the processor::allocates the processor
process * de-allocates::process * de-allocates
processor when processor::processor when processor
management os manages::management os manages
manages device communication::manages device communication
respective drivers operating::respective drivers operating
drivers operating system::drivers operating system
activities for device::activities for device
devices program responsible::devices program responsible
controller * decides::controller * decides
allocates the device::allocates the device
de-allocates devices file::de-allocates devices file
devices file management::devices file management
management a file::management a file
organized into directories::organized into directories
directories for easy::directories for easy
navigation and usage::navigation and usage
usage these directories::usage these directories
directions operating system::directions operating system
activities for file::activities for file
track of information::track of information
system * decides::system * decides
resources * allocates::resources * allocates
allocates the resources::allocates the resources
resources * de-allocates::resources * de-allocates
de-allocates the resources::de-allocates the resources
resources other important::resources other important
activities that operating::activities that operating
means of password::means of password
password and similar::password and similar
similar other techniques::similar other techniques
preventing unauthorized access::preventing unauthorized access
access to programs::access to programs
programs and data::programs and data
data * control::data * control
delays between request::delays between request
service and response::service and response
system * job::system * job
jobs and users::jobs and users
users * error::users * error
production of dumps::production of dumps
debugging and error::debugging and error
coordination and assignment::coordination and assignment
assignment of compilers::assignment of compilers
types of operating::types of operating
systems this section::systems this section
describes various types::describes various types
operating systems operating::operating systems operating
systems operating systems::systems operating systems
first computer generation::first computer generation
computer generation operating::computer generation operating
generation operating systems::generation operating systems
systems keep evolving::systems keep evolving
commonly used batch::commonly used batch
batch operating system::batch operating system
system the users::system the users
users of batch::users of batch
directly each user::directly each user
prepares his job::prepares his job
device like punch::device like punch
cards and submits::cards and submits
operator to speed::operator to speed
speed up processing::speed up processing
jobs with similar::jobs with similar
left their programs::left their programs
operator the operator::operator the operator
operator then sorts::operator then sorts
programs into batches::programs into batches
batches with similar::batches with similar
requirements the problems::requirements the problems
problems with batch::problems with batch
lack of interaction::lack of interaction
user and job::user and job
job * cpu::job * cpu
mechanical i devices::mechanical NN devices
devices are slower::devices are slower
slower than cpu::slower than cpu
cpu * difficult::cpu * difficult
difficult to provide::difficult to provide
provide the desired::provide the desired
time-sharing operating systems::time-sharing operating systems
systems time sharing::systems time sharing
technique which enables::technique which enables
enables many people::enables many people
time-sharing or multitasking::time-sharing or multitasking
extension of multiprogramming::extension of multiprogramming
shared among multiple::shared among multiple
simultaneously is termed::simultaneously is termed
termed as time-sharing::termed as time-sharing
time-sharing the main::time-sharing the main
difference between multiprogrammed::difference between multiprogrammed
multiprogrammed batch systems::multiprogrammed batch systems
systems and time-sharing::systems and time-sharing
case of multiprogrammed::case of multiprogrammed
time-sharing systems objective::time-sharing systems objective
response time multiple::response time multiple
jobs are executed::jobs are executed
cpu by switching::cpu by switching
occur so frequently::occur so frequently
user can receive::user can receive
execute each user::execute each user
burst or quantum::burst or quantum
quantum of computation::quantum of computation
users are present::users are present
submits the command::submits the command
system uses cpu::system uses cpu
scheduling and multiprogramming::scheduling and multiprogramming
multiprogramming to provide::multiprogramming to provide
provide each user::provide each user
primarily as batch::primarily as batch
modified to time-sharing::modified to time-sharing
time-sharing systems advantages::time-sharing systems advantages
advantages of timesharing::advantages of timesharing
timesharing operating systems::timesharing operating systems
advantage of quick::advantage of quick
response * avoids::response * avoids
duplication of software::duplication of software
software * reduces::software * reduces
reduces cpu idle::reduces cpu idle
idle time disadvantages::idle time disadvantages
disadvantages of timesharing::disadvantages of timesharing
problem of reliability::problem of reliability
reliability * question::reliability * question
question of security::question of security
security and integrity::security and integrity
integrity of user::integrity of user
data * problem::data * problem
problem of data::problem of data
distributed operating system::distributed operating system
operating system distributed::operating system distributed
system distributed systems::system distributed systems
systems use multiple::systems use multiple
multiple central processors::multiple central processors
processors to serve::processors to serve
serve multiple real::serve multiple real
real time application::real time application
application and multiple::application and multiple
multiple users data::multiple users data
users data processing::users data processing
data processing jobs::data processing jobs
jobs are distributed::jobs are distributed
perform each job::perform each job
job most efficiently::job most efficiently
efficiently the processors::efficiently the processors
buses or telephone::buses or telephone
loosely coupled systems::loosely coupled systems
systems or distributed::systems or distributed
distributed systems processors::distributed systems processors
system may vary::system may vary
vary in size::vary in size
size and function::size and function
function these processors::function these processors
processors are referred::processors are referred
referred as sites::referred as sites
advantages of distributed::advantages of distributed
resource sharing facility::resource sharing facility
sharing facility user::sharing facility user
speedup the exchange::speedup the exchange
exchange of data::exchange of data
potentially continue operating::potentially continue operating
customers * reduction::customers * reduction
computer * reduction::computer * reduction
reduction of delays::reduction of delays
delays in data::delays in data
network operating system::network operating system
operating system network::operating system network
system network operating::system network operating
operating system runs::operating system runs
server the capability::server the capability
capability to manage::capability to manage
functions the primary::functions the primary
file and printer::file and printer
access among multiple::access among multiple
typically a local::typically a local
local area network::local area network
examples of network::examples of network
network operating systems::network operating systems
systems are microsoft::systems are microsoft
bsd the advantages::bsd the advantages
advantages of network::advantages of network
stable * security::stable * security
managed * upgrades::managed * upgrades
technologies and hardware::technologies and hardware
system * remote::system * remote
access to servers::access to servers
locations and types::locations and types
types of systems::types of systems
systems the disadvantages::systems the disadvantages
disadvantages of network::disadvantages of network
cost of buying::cost of buying
buying and running::buying and running
running a server::running a server
server * dependency::server * dependency
operations * regular::operations * regular
maintenance and updates::maintenance and updates
updates are required::updates are required
real time operating::real time operating
operating system real::operating system real
real time system::real time system
system is defines::system is defines
data processing system::data processing system
required to process::required to process
process and respond::process and respond
respond to inputs::respond to inputs
controls the environment::controls the environment
real time processing::real time processing
system to respond::system to respond
input and display::input and display
display of required::display of required
required updated information::required updated information
information is termed::information is termed
termed as response::termed as response
online processing real-time::online processing real-time
processing real-time systems::processing real-time systems
rigid time requirements::rigid time requirements
flow of data::flow of data
data and real-time::data and real-time
dedicated application real-time::dedicated application real-time
application real-time operating::application real-time operating
real-time operating system::real-time operating system
system has well-defined::system has well-defined
fixed time constraints::fixed time constraints
constraints otherwise system::constraints otherwise system
system will fail::system will fail
medical imaging systems::medical imaging systems
industrial control systems::industrial control systems
air traffic control::air traffic control
traffic control system::traffic control system
types of real-time::types of real-time
real-time operating systems::real-time operating systems
operating systems hard::operating systems hard
systems hard real-time::systems hard real-time
hard real-time systems::hard real-time systems
real-time systems guarantee::real-time systems guarantee
guarantee that critical::guarantee that critical
critical tasks complete::critical tasks complete
real-time systems secondary::real-time systems secondary
systems secondary storage::systems secondary storage
storage is limited::storage is limited
limited or missing::limited or missing
missing with data::missing with data
stored in rom::stored in rom
systems virtual memory::systems virtual memory
found soft real-time::found soft real-time
soft real-time systems::soft real-time systems
real-time systems soft::real-time systems soft
systems soft real::systems soft real
real time systems::real time systems
restrictive critical real-time::restrictive critical real-time
critical real-time task::critical real-time task
task gets priority::task gets priority
tasks and retains::tasks and retains
retains the priority::retains the priority
completes soft real-time::completes soft real-time
systems have limited::systems have limited
utility than hard::utility than hard
hard realtime systems::hard realtime systems
advanced scientific projects::advanced scientific projects
projects like undersea::projects like undersea
exploration and planetary::exploration and planetary
operating system::operating system
computer hardware::computer hardware
execute programs::execute programs
technical terms::technical terms
manages hardware::manages hardware
system controls::system controls
information definition::information definition
important functions::important functions
memory management::memory management
processor management::processor management
device management::device management
file management::file management
system performance::system performance
detecting aids::detecting aids
users memory::users memory
management memory::management memory
management refers::management refers
primary memory::primary memory
main memory::main memory
memory main::memory main
large array::large array
address main::address main
fast storage::fast storage
memory operating::memory operating
memory i.e::memory i.e
process requests::process requests
terminated processor::terminated processor
multiprogramming environment::multiprogramming environment
process scheduling::process scheduling
scheduling operating::scheduling operating
process program::process program
traffic controller::traffic controller
de-allocates processor::de-allocates processor
longer required::longer required
manages device::manages device
device communication::device communication
respective drivers::respective drivers
drivers operating::drivers operating
devices program::devices program
de-allocates devices::de-allocates devices
devices file::devices file
file system::file system
easy navigation::easy navigation
directions operating::directions operating
collective facilities::collective facilities
important activities::important activities
unauthorized access::unauthorized access
recording delays::recording delays
keeping track::keeping track
error messages::error messages
error detecting::error detecting
computer systems::computer systems
operating systems::operating systems
section describes::section describes
systems operating::systems operating
first computer::first computer
computer generation::computer generation
generation operating::generation operating
important types::important types
batch operating::batch operating
computer directly::computer directly
user prepares::user prepares
off-line device::off-line device
punch cards::punch cards
computer operator::computer operator
programmers left::programmers left
sorts programs::sorts programs
similar requirements::similar requirements
batch systems::batch systems
desired priority::desired priority
time-sharing operating::time-sharing operating
computer system::computer system
logical extension::logical extension
multiprogramming processor::multiprogramming processor
multiple users::multiple users
main difference::main difference
multiprogrammed batch::multiprogrammed batch
time-sharing systems::time-sharing systems
maximize processor::maximize processor
minimize response::minimize response
multiple jobs::multiple jobs
switches occur::switches occur
transaction processing::transaction processing
processor execute::processor execute
user program::user program
short burst::short burst
user submits::user submits
small portion::small portion
systems advantages::systems advantages
timesharing operating::timesharing operating
provide advantage::provide advantage
quick response::quick response
avoids duplication::avoids duplication
user programs::user programs
data communication::data communication
distributed operating::distributed operating
system distributed::system distributed
distributed systems::distributed systems
central processors::central processors
serve multiple::serve multiple
multiple real::multiple real
users data::users data
data processing::data processing
processing jobs::processing jobs
processors communicate::processors communicate
communication lines::communication lines
high-speed buses::high-speed buses
telephone lines::telephone lines
coupled systems::coupled systems
systems processors::systems processors
distributed system::distributed system
resource sharing::resource sharing
sharing facility::sharing facility
facility user::facility user
electronic mail::electronic mail
site fails::site fails
remaining sites::remaining sites
continue operating::continue operating
host computer::host computer
network operating::network operating
system network::system network
system runs::system runs
manage data::manage data
networking functions::networking functions
primary purpose::primary purpose
printer access::printer access
multiple computers::multiple computers
local area::local area
area network::area network
private network::private network
networks examples::networks examples
microsoft windows::microsoft windows
novell netware::novell netware
centralized servers::centralized servers
highly stable::highly stable
server managed::server managed
remote access::remote access
high cost::high cost
central location::central location
regular maintenance::regular maintenance
system real::system real
processing system::processing system
interval required::interval required
line system::line system
updated information::updated information
method response::method response
online processing::online processing
processing real-time::processing real-time
real-time systems::real-time systems
control device::control device
dedicated application::dedicated application
application real-time::application real-time
real-time operating::real-time operating
scientific experiments::scientific experiments
medical imaging::medical imaging
imaging systems::imaging systems
industrial control::industrial control
control systems::control systems
weapon systems::weapon systems
home-appliance controllers::home-appliance controllers
air traffic::air traffic
traffic control::traffic control
control system::control system
systems hard::systems hard
systems guarantee::systems guarantee
critical tasks::critical tasks
hard real-time::hard real-time
secondary storage::secondary storage
data stored::data stored
virtual memory::virtual memory
found soft::found soft
soft real::soft real
critical real-time::critical real-time
real-time task::real-time task
completes soft::completes soft
limited utility::limited utility
hard realtime::hard realtime
realtime systems::realtime systems
virtual reality::virtual reality
scientific projects::scientific projects
undersea exploration::undersea exploration
planetary rovers::planetary rovers
operating::operating
system::system
intermediary::intermediary
users::users
computer::computer
hardware::hardware
environment::environment
user::user
execute::execute
programs::programs
conveniently::conveniently
efficiently::efficiently
technical::technical
terms::terms
software::software
manages::manages
controls::controls
allocation::allocation
resources::resources
services::services
memory::memory
processors::processors
devices::devices
information::information
definition::definition
program::program
acts::acts
interface::interface
execution::execution
kinds::kinds
important::important
functions::functions
management::management
processor::processor
device::device
file::file
security::security
control::control
performance::performance
job::job
accounting::accounting
error::error
detecting::detecting
aids::aids
coordination::coordination
refers::refers
primary::primary
main::main
large::large
array::array
words::words
bytes::bytes
word::word
byte::byte
address::address
fast::fast
storage::storage
access::access
directly::directly
cpu::cpu
executed::executed
activities::activities
tracks::tracks
i.e::i.e
part::part
multiprogramming::multiprogramming
decides::decides
process::process
allocates::allocates
requests::requests
de-allocates::de-allocates
longer::longer
terminated::terminated
function::function
scheduling::scheduling
status::status
responsible::responsible
task::task
traffic::traffic
controller::controller
required::required
communication::communication
respective::respective
drivers::drivers
i::NNP
efficient::efficient
organized::organized
directories::directories
easy::easy
navigation::navigation
usage::usage
files::files
directions::directions
track::track
location::location
collective::collective
facilities::facilities
means::means
password::password
similar::similar
techniques::techniques
preventing::preventing
unauthorized::unauthorized
data::data
recording::recording
delays::delays
request::request
service::service
response::response
keeping::keeping
jobs::jobs
production::production
dumps::dumps
traces::traces
messages::messages
debugging::debugging
assignment::assignment
compilers::compilers
interpreters::interpreters
assemblers::assemblers
systems::systems
types::types
section::section
describes::describes
first::first
generation::generation
evolving::evolving
period::period
commonly::commonly
batch::batch
interact::interact
prepares::prepares
off-line::off-line
punch::punch
cards::cards
submits::submits
operator::operator
speed::speed
processing::processing
batched::batched
run::run
group::group
programmers::programmers
left::left
sorts::sorts
batches::batches
requirements::requirements
problems::problems
lack::lack
interaction::interaction
idle::idle
speeds::speeds
mechanical::mechanical
slower::slower
difficult::difficult
provide::provide
desired::desired
priority::priority
time-sharing::time-sharing
sharing::sharing
technique::technique
enables::enables
people::people
located::located
terminals::terminals
multitasking::multitasking
logical::logical
extension::extension
shared::shared
multiple::multiple
simultaneously::simultaneously
termed::termed
difference::difference
multiprogrammed::multiprogrammed
case::case
objective::objective
maximize::maximize
minimize::minimize
switching::switching
switches::switches
occur::occur
frequently::frequently
receive::receive
transaction::transaction
short::short
burst::burst
quantum::quantum
computation::computation
present::present
command::command
seconds::seconds
small::small
portion::portion
designed::designed
primarily::primarily
modified::modified
advantages::advantages
timesharing::timesharing
advantage::advantage
quick::quick
avoids::avoids
duplication::duplication
reduces::reduces
disadvantages::disadvantages
problem::problem
reliability::reliability
question::question
integrity::integrity
distributed::distributed
central::central
serve::serve
real::real
application::application
perform::perform
communicate::communicate
lines::lines
high-speed::high-speed
buses::buses
telephone::telephone
referred::referred
loosely::loosely
coupled::coupled
vary::vary
size::size
sites::sites
nodes::nodes
computers::computers
resource::resource
facility::facility
site::site
speedup::speedup
exchange::exchange
electronic::electronic
mail::mail
fails::fails
remaining::remaining
potentially::potentially
continue::continue
customers::customers
reduction::reduction
load::load
host::host
network::network
runs::runs
server::server
capability::capability
manage::manage
groups::groups
applications::applications
networking::networking
purpose::purpose
printer::printer
typically::typically
local::local
area::area
lan::lan
private::private
networks::networks
examples::examples
microsoft::microsoft
windows::windows
unix::unix
linux::linux
mac::mac
novell::novell
netware::netware
bsd::bsd
centralized::centralized
servers::servers
highly::highly
stable::stable
managed::managed
upgrades::upgrades
technologies::technologies
easily::easily
integrated::integrated
remote::remote
locations::locations
high::high
cost::cost
buying::buying
running::running
dependency::dependency
operations::operations
regular::regular
maintenance::maintenance
updates::updates
defines::defines
interval::interval
respond::respond
inputs::inputs
line::line
input::input
display::display
updated::updated
method::method
compared::compared
online::online
real-time::real-time
rigid::rigid
operation::operation
flow::flow
dedicated::dedicated
well-defined::well-defined
fixed::fixed
constraints::constraints
fail::fail
scientific::scientific
experiments::experiments
medical::medical
imaging::imaging
industrial::industrial
weapon::weapon
robots::robots
home-appliance::home-appliance
controllers::controllers
air::air
two::two
hard::hard
guarantee::guarantee
critical::critical
tasks::tasks
complete::complete
secondary::secondary
limited::limited
missing::missing
stored::stored
rom::rom
virtual::virtual
found::found
soft::soft
restrictive::restrictive
retains::retains
completes::completes
utility::utility
realtime::realtime
multimedia::multimedia
reality::reality
advanced::advanced
projects::projects
undersea::undersea
exploration::exploration
planetary::planetary
rovers::rovers
