intermediary between users::intermediary between users
users and computer::users and computer
users an environment::users an environment
user can execute::user can execute
conveniently and efficiently::conveniently and efficiently
efficiently in technical::efficiently in technical
software which manages::software which manages
hardware an operating::hardware an operating
operating system controls::operating system controls
controls the allocation::controls the allocation
allocation of resources::allocation of resources
resources and services::resources and services
devices and information::devices and information
definition an operating::definition an operating
program that acts::program that acts
hardware and controls::hardware and controls
controls the execution::controls the execution
kinds of programs::kinds of programs
programs conceptual view::programs conceptual view
operating system memory::operating system memory
system memory management::system memory management
memory management processor::memory management processor
management processor management::management processor management
processor management device::processor management device
management device management::management device management
device management file::device management file
management file management::management file management
file management security::file management security
management security control::management security control
control over system::control over system
system performance job::system performance job
performance job accounting::performance job accounting
job accounting error::job accounting error
accounting error detecting::accounting error detecting
error detecting aids::error detecting aids
detecting aids coordination::detecting aids coordination
software and users::software and users
users memory management::users memory management
memory management memory::memory management memory
management memory management::management memory management
memory management refers::memory management refers
refers to management::refers to management
management of primary::management of primary
memory or main::memory or main
main memory main::main memory main
memory main memory::memory main memory
array of words::array of words
words or bytes::words or bytes
word or byte::word or byte
address main memory::address main memory
main memory operating::main memory operating
memory operating system::memory operating system
activities for memory::activities for memory
management keeps tracks::management keeps tracks
tracks of primary::tracks of primary
primary memory i.e::primary memory i.e
i.e what part::i.e what part
decides which process::decides which process
allocates the memory::allocates the memory
de-allocates the memory::de-allocates the memory
process no longer::process no longer
terminated the task::terminated the task
task of fulfilling::task of fulfilling
fulfilling an allocation::fulfilling an allocation
allocation request consists::allocation request consists
consists of locating::consists of locating
locating a block::locating a block
block of unused::block of unused
memory of sufficient::memory of sufficient
sufficient size memory::sufficient size memory
size memory requests::size memory requests
requests are satisfied::requests are satisfied
satisfied by allocating::satisfied by allocating
pool of memory::pool of memory
heap or free::heap or free
allocations several issues::allocations several issues
complicate the implementation::complicate the implementation
gaps between allocated::gaps between allocated
allocated memory blocks::allocated memory blocks
request the allocator::request the allocator
allocator s metadata::allocator s metadata
inflate the size::inflate the size
managed by chunking::managed by chunking
chunking the memory::chunking the memory
memory management system::memory management system
system must track::system must track
track outstanding allocations::track outstanding allocations
allocations to ensure::allocations to ensure
memory leak efficiency::memory leak efficiency
specific dynamic memory::specific dynamic memory
dynamic memory allocation::dynamic memory allocation
memory allocation algorithm::memory allocation algorithm
allocation algorithm implemented::allocation algorithm implemented
implemented can impact::implemented can impact
impact performance significantly::impact performance significantly
significantly a study::significantly a study
digital equipment corporation::digital equipment corporation
equipment corporation illustrates::equipment corporation illustrates
illustrates the overheads::illustrates the overheads
variety of allocators::variety of allocators
allocators the lowest::allocators the lowest
lowest average instruction::lowest average instruction
average instruction path::average instruction path
instruction path length::instruction path length
path length required::path length required
required to allocate::required to allocate
allocate a single::allocate a single
single memory slot::single memory slot
instruction level profiler::instruction level profiler
variety of software::variety of software
memory is accessed::memory is accessed
reference the specific::reference the specific
organize the memory::organize the memory
area and allocate::area and allocate
allocate and deallocate::allocate and deallocate
chunks is interlinked::chunks is interlinked
fixed-size blocks allocation::fixed-size blocks allocation
memory pool fixed-size::memory pool fixed-size
pool fixed-size blocks::pool fixed-size blocks
memory pool allocation::memory pool allocation
list of fixed-size::list of fixed-size
blocks of memory::blocks of memory
simple embedded systems::simple embedded systems
suffers from fragmentation::suffers from fragmentation
long memory addresses::long memory addresses
significantly reduced overhead::significantly reduced overhead
overhead this method::overhead this method
substantially improve performance::substantially improve performance
performance for objects::performance for objects
video games buddy::video games buddy
games buddy blocks::games buddy blocks
buddy memory allocation::buddy memory allocation
memory is allocated::memory is allocated
pools of memory::pools of memory
pool represents blocks::pool represents blocks
two in size::two in size
size all blocks::size all blocks
sorted linked list::sorted linked list
list or tree::list or tree
formed during allocation::formed during allocation
allocation are added::allocation are added
respective memory pools::respective memory pools
size is requested::size is requested
smallest available size::smallest available size
size is selected::size is selected
selected and halved::selected and halved
halves is selected::halves is selected
request is complete::request is complete
block is allocated::block is allocated
allocator will start::allocator will start
smallest sufficiently large::smallest sufficiently large
sufficiently large block::sufficiently large block
block to avoid::block to avoid
avoid needlessly breaking::avoid needlessly breaking
needlessly breaking blocks::needlessly breaking blocks
block is freed::block is freed
next-largest size buddy-block::next-largest size buddy-block
size buddy-block list::size buddy-block list
buddy-block list systems::buddy-block list systems
systems with virtual::systems with virtual
protection and shared::protection and shared
shared memory virtual::shared memory virtual
memory virtual memory::memory virtual memory
method of decoupling::method of decoupling
decoupling the memory::decoupling the memory
hardware the applications::hardware the applications
applications operate memory::applications operate memory
memory via virtual::memory via virtual
attempt to access::attempt to access
access stored data::access stored data
data is made::data is made
virtual memory data::virtual memory data
memory data orders::memory data orders
data orders translate::data orders translate
translate the virtual::translate the virtual
addition of virtual::addition of virtual
virtual memory enables::virtual memory enables
memory enables granular::memory enables granular
enables granular control::enables granular control
control over memory::control over memory
systems and methods::systems and methods
methods of access::methods of access
access in virtual::access in virtual
virtual memory systems::virtual memory systems
systems the operating::systems the operating
operating system limits::operating system limits
process can access::process can access
access the memory::access the memory
memory this feature::memory this feature
disallow a process::disallow a process
process to read::process to read
read or write::read or write
write to memory::write to memory
malicious or malfunctioning::malicious or malfunctioning
program from interfering::program from interfering
allocated for specific::allocated for specific
share information shared::share information shared
information shared memory::information shared memory
techniques for inter-process::techniques for inter-process
inter-process communication memory::inter-process communication memory
classified by access::classified by access
rate into primary::rate into primary
storage and secondary::storage and secondary
secondary storage memory::secondary storage memory
storage memory management::storage memory management
memory management systems::memory management systems
handle the moving::handle the moving
moving of information::moving of information
levels of memory::levels of memory
memory processor management::memory processor management
management in multiprogramming::management in multiprogramming
process scheduling operating::process scheduling operating
scheduling operating system::scheduling operating system
activities for processor::activities for processor
tracks of processor::tracks of processor
processor and status::processor and status
status of process::status of process
process program responsible::process program responsible
traffic controller allocates::traffic controller allocates
allocates the processor::allocates the processor
process de-allocates processor::process de-allocates processor
processor when processor::processor when processor
longer required device::longer required device
required device management::required device management
management os manages::management os manages
manages device communication::manages device communication
respective drivers operating::respective drivers operating
drivers operating system::drivers operating system
activities for device::activities for device
devices program responsible::devices program responsible
i controller decides::NNP controller decides
allocates the device::allocates the device
efficient way de-allocates::efficient way de-allocates
de-allocates devices file::de-allocates devices file
devices file management::devices file management
management a file::management a file
organized into directories::organized into directories
directories for easy::directories for easy
navigation and usage::navigation and usage
usage these directories::usage these directories
directions operating system::directions operating system
activities for file::activities for file
management keeps track::management keeps track
track of information::track of information
file system decides::file system decides
allocates the resources::allocates the resources
de-allocates the resources::de-allocates the resources
resources other important::resources other important
activities that operating::activities that operating
system does security::system does security
means of password::means of password
password and similar::password and similar
similar other techniques::similar other techniques
preventing unauthorized access::preventing unauthorized access
access to programs::access to programs
programs and data::programs and data
delays between request::delays between request
service and response::service and response
system job accounting::system job accounting
jobs and users::jobs and users
users error detecting::users error detecting
production of dumps::production of dumps
debugging and error::debugging and error
softwares and users::softwares and users
coordination and assignment::coordination and assignment
assignment of compilers::assignment of compilers
operating system::operating system
computer hardware::computer hardware
execute programs::execute programs
technical terms::technical terms
manages hardware::manages hardware
system controls::system controls
information definition::information definition
conceptual view::conceptual view
important functions::important functions
system memory::system memory
memory management::memory management
management processor::management processor
processor management::processor management
management device::management device
device management::device management
management file::management file
file management::file management
management security::management security
security control::security control
system performance::system performance
performance job::performance job
job accounting::job accounting
accounting error::accounting error
error detecting::error detecting
detecting aids::detecting aids
aids coordination::aids coordination
users memory::users memory
management memory::management memory
management refers::management refers
primary memory::primary memory
main memory::main memory
memory main::memory main
large array::large array
address main::address main
fast storage::fast storage
memory operating::memory operating
memory i.e::memory i.e
process requests::process requests
allocation request::allocation request
request consists::request consists
unused memory::unused memory
sufficient size::sufficient size
size memory::size memory
memory requests::memory requests
allocating portions::allocating portions
large pool::large pool
free store::free store
future allocations::future allocations
issues complicate::issues complicate
external fragmentation::external fragmentation
small gaps::small gaps
allocated memory::allocated memory
memory blocks::memory blocks
small allocations::small allocations
management system::management system
outstanding allocations::outstanding allocations
memory leak::memory leak
leak efficiency::leak efficiency
specific dynamic::specific dynamic
dynamic memory::dynamic memory
memory allocation::memory allocation
allocation algorithm::allocation algorithm
algorithm implemented::algorithm implemented
impact performance::impact performance
performance significantly::performance significantly
study conducted::study conducted
digital equipment::digital equipment
equipment corporation::equipment corporation
corporation illustrates::corporation illustrates
overheads involved::overheads involved
lowest average::lowest average
average instruction::average instruction
instruction path::instruction path
path length::path length
length required::length required
single memory::single memory
memory slot::memory slot
instruction level::instruction level
level profiler::level profiler
precise location::precise location
pointer reference::pointer reference
specific algorithm::specific algorithm
memory area::memory area
deallocate chunks::deallocate chunks
fixed-size blocks::fixed-size blocks
blocks allocation::blocks allocation
main article::main article
memory pool::memory pool
pool fixed-size::pool fixed-size
pool allocation::pool allocation
free list::free list
embedded systems::embedded systems
large objects::large objects
memory addresses::memory addresses
improve performance::improve performance
frequent allocation::frequent allocation
video games::video games
games buddy::games buddy
buddy blocks::buddy blocks
buddy memory::buddy memory
pool represents::pool represents
represents blocks::represents blocks
linked list::linked list
respective memory::respective memory
memory pools::memory pools
smaller size::smaller size
resulting halves::resulting halves
process repeats::process repeats
large block::large block
breaking blocks::breaking blocks
next-largest size::next-largest size
size buddy-block::size buddy-block
buddy-block list::buddy-block list
list systems::list systems
virtual memory::virtual memory
main articles::main articles
memory protection::memory protection
shared memory::shared memory
memory organization::memory organization
physical hardware::physical hardware
applications operate::applications operate
operate memory::operate memory
virtual addresses::virtual addresses
access stored::access stored
stored data::stored data
memory data::memory data
data orders::data orders
orders translate::orders translate
virtual address::virtual address
physical address::physical address
memory enables::memory enables
granular control::granular control
memory systems::memory systems
system limits::system limits
malfunctioning code::malfunctioning code
memory allocated::memory allocated
specific processes::specific processes
share information::share information
information shared::information shared
fastest techniques::fastest techniques
inter-process communication::inter-process communication
communication memory::communication memory
access rate::access rate
primary storage::primary storage
secondary storage::secondary storage
storage memory::storage memory
management systems::management systems
memory processor::memory processor
multiprogramming environment::multiprogramming environment
process scheduling::process scheduling
scheduling operating::scheduling operating
process program::process program
traffic controller::traffic controller
controller allocates::controller allocates
process de-allocates::process de-allocates
de-allocates processor::de-allocates processor
longer required::longer required
required device::required device
manages device::manages device
device communication::device communication
respective drivers::respective drivers
drivers operating::drivers operating
devices program::devices program
controller decides::controller decides
de-allocates devices::de-allocates devices
devices file::devices file
file system::file system
easy navigation::easy navigation
directions operating::directions operating
collective facilities::collective facilities
system decides::system decides
resources allocates::resources allocates
resources de-allocates::resources de-allocates
important activities::important activities
unauthorized access::unauthorized access
data control::data control
recording delays::recording delays
system job::system job
keeping track::keeping track
users error::users error
error messages::error messages
computer systems::computer systems
operating::operating
system::system
intermediary::intermediary
users::users
computer::computer
hardware::hardware
environment::environment
user::user
execute::execute
programs::programs
conveniently::conveniently
efficiently::efficiently
technical::technical
terms::terms
software::software
manages::manages
controls::controls
allocation::allocation
resources::resources
services::services
memory::memory
processors::processors
devices::devices
information::information
definition::definition
program::program
acts::acts
interface::interface
execution::execution
kinds::kinds
conceptual::conceptual
view::view
important::important
functions::functions
management::management
processor::processor
device::device
file::file
security::security
control::control
performance::performance
job::job
accounting::accounting
error::error
detecting::detecting
aids::aids
coordination::coordination
refers::refers
primary::primary
main::main
large::large
array::array
words::words
bytes::bytes
word::word
byte::byte
address::address
fast::fast
storage::storage
access::access
directly::directly
cpu::cpu
executed::executed
activities::activities
tracks::tracks
i.e::i.e
part::part
multiprogramming::multiprogramming
decides::decides
process::process
allocates::allocates
requests::requests
de-allocates::de-allocates
longer::longer
terminated::terminated
task::task
fulfilling::fulfilling
request::request
consists::consists
locating::locating
block::block
unused::unused
sufficient::sufficient
size::size
satisfied::satisfied
allocating::allocating
portions::portions
pool::pool
heap::heap
free::free
store::store
parts::parts
future::future
allocations::allocations
issues::issues
complicate::complicate
implementation::implementation
external::external
fragmentation::fragmentation
arises::arises
small::small
gaps::gaps
allocated::allocated
blocks::blocks
invalidates::invalidates
allocator::allocator
metadata::metadata
inflate::inflate
individually::individually
managed::managed
chunking::chunking
track::track
outstanding::outstanding
ensure::ensure
overlap::overlap
lost::lost
leak::leak
efficiency::efficiency
edit::edit
specific::specific
dynamic::dynamic
algorithm::algorithm
implemented::implemented
impact::impact
significantly::significantly
study::study
conducted::conducted
digital::digital
equipment::equipment
corporation::corporation
illustrates::illustrates
overheads::overheads
involved::involved
variety::variety
allocators::allocators
lowest::lowest
average::average
instruction::instruction
path::path
length::length
required::required
allocate::allocate
single::single
slot::slot
measured::measured
level::level
profiler::profiler
implementations::implementations
precise::precise
location::location
advance::advance
accessed::accessed
indirectly::indirectly
pointer::pointer
reference::reference
organize::organize
area::area
deallocate::deallocate
chunks::chunks
interlinked::interlinked
kernel::kernel
methods::methods
fixed-size::fixed-size
article::article
list::list
works::works
simple::simple
embedded::embedded
systems::systems
objects::objects
suffers::suffers
long::long
addresses::addresses
due::due
reduced::reduced
overhead::overhead
method::method
substantially::substantially
improve::improve
frequent::frequent
de-allocation::de-allocation
video::video
games::games
buddy::buddy
details::details
topic::topic
pools::pools
represents::represents
power::power
two::two
sorted::sorted
linked::linked
tree::tree
formed::formed
added::added
respective::respective
smaller::smaller
requested::requested
smallest::smallest
selected::selected
halved::halved
resulting::resulting
halves::halves
repeats::repeats
complete::complete
start::start
sufficiently::sufficiently
avoid::avoid
needlessly::needlessly
breaking::breaking
freed::freed
compared::compared
combined::combined
next-largest::next-largest
buddy-block::buddy-block
virtual::virtual
articles::articles
protection::protection
shared::shared
decoupling::decoupling
organization::organization
physical::physical
applications::applications
operate::operate
attempt::attempt
stored::stored
data::data
made::made
orders::orders
translate::translate
addition::addition
enables::enables
granular::granular
limits::limits
feature::feature
disallow::disallow
read::read
write::write
preventing::preventing
malicious::malicious
malfunctioning::malfunctioning
code::code
interfering::interfering
operation::operation
processes::processes
isolated::isolated
share::share
fastest::fastest
techniques::techniques
inter-process::inter-process
communication::communication
classified::classified
rate::rate
secondary::secondary
operations::operations
handle::handle
moving::moving
levels::levels
function::function
scheduling::scheduling
status::status
responsible::responsible
traffic::traffic
controller::controller
drivers::drivers
i::NNP
efficient::efficient
organized::organized
directories::directories
easy::easy
navigation::navigation
usage::usage
files::files
directions::directions
collective::collective
facilities::facilities
means::means
password::password
similar::similar
unauthorized::unauthorized
recording::recording
delays::delays
service::service
response::response
keeping::keeping
jobs::jobs
production::production
dumps::dumps
traces::traces
messages::messages
debugging::debugging
softwares::softwares
assignment::assignment
compilers::compilers
interpreters::interpreters
assemblers::assemblers
