intermediary between users::intermediary between users
users and computer::users and computer
users an environment::users an environment
user can execute::user can execute
conveniently and efficiently::conveniently and efficiently
efficiently in technical::efficiently in technical
software which manages::software which manages
hardware an operating::hardware an operating
operating system controls::operating system controls
controls the allocation::controls the allocation
allocation of resources::allocation of resources
resources and services::resources and services
devices and information::devices and information
definition an operating::definition an operating
program that acts::program that acts
hardware and controls::hardware and controls
controls the execution::controls the execution
kinds of programs::kinds of programs
programs conceptual view::programs conceptual view
operating system memory::operating system memory
system memory management::system memory management
memory management processor::memory management processor
management processor management::management processor management
processor management device::processor management device
management device management::management device management
device management file::device management file
management file management::management file management
file management security::file management security
management security control::management security control
control over system::control over system
system performance job::system performance job
performance job accounting::performance job accounting
job accounting error::job accounting error
accounting error detecting::accounting error detecting
error detecting aids::error detecting aids
detecting aids coordination::detecting aids coordination
software and users::software and users
types of operating::types of operating
operating system operating::operating system operating
system operating systems::system operating systems
first computer generation::first computer generation
computer generation operating::computer generation operating
generation operating systems::generation operating systems
systems keep evolving::systems keep evolving
commonly used batch::commonly used batch
batch operating system::batch operating system
system the users::system the users
users of batch::users of batch
directly each user::directly each user
prepares his job::prepares his job
device like punch::device like punch
cards and submits::cards and submits
operator to speed::operator to speed
speed up processing::speed up processing
jobs with similar::jobs with similar
left their programs::left their programs
operator the operator::operator the operator
operator then sorts::operator then sorts
programs into batches::programs into batches
batches with similar::batches with similar
requirements the problems::requirements the problems
problems with batch::problems with batch
lack of interaction::lack of interaction
user and job::user and job
mechanical i devices::mechanical NN devices
devices is slower::devices is slower
slower than cpu::slower than cpu
difficult to provide::difficult to provide
provide the desired::provide the desired
desired priority time-sharing::desired priority time-sharing
priority time-sharing operating::priority time-sharing operating
time-sharing operating systems::time-sharing operating systems
systems time sharing::systems time sharing
technique which enables::technique which enables
enables many people::enables many people
time-sharing or multitasking::time-sharing or multitasking
extension of multiprogramming::extension of multiprogramming
shared among multiple::shared among multiple
simultaneously is termed::simultaneously is termed
termed as time-sharing::termed as time-sharing
time-sharing the main::time-sharing the main
difference between multiprogrammed::difference between multiprogrammed
multiprogrammed batch systems::multiprogrammed batch systems
systems and time-sharing::systems and time-sharing
case of multiprogrammed::case of multiprogrammed
time-sharing systems objective::time-sharing systems objective
response time multiple::response time multiple
jobs are executed::jobs are executed
cpu by switching::cpu by switching
occur so frequently::occur so frequently
user can receives::user can receives
execute each user::execute each user
burst or quantum::burst or quantum
quantum of computation::quantum of computation
users are present::users are present
submits the command::submits the command
distributed operating system::distributed operating system
operating system distributed::operating system distributed
system distributed systems::system distributed systems
systems use multiple::systems use multiple
multiple central processors::multiple central processors
processors to serve::processors to serve
serve multiple real::serve multiple real
real time application::real time application
application and multiple::application and multiple
multiple users data::multiple users data
users data processing::users data processing
data processing jobs::data processing jobs
jobs are distributed::jobs are distributed
perform each job::perform each job
job most efficiently::job most efficiently
efficiently the processors::efficiently the processors
buses or telephone::buses or telephone
loosely coupled systems::loosely coupled systems
systems or distributed::systems or distributed
distributed systems processors::distributed systems processors
system may vary::system may vary
vary in size::vary in size
size and function::size and function
function these processors::function these processors
processors are referred::processors are referred
referred as sites::referred as sites
network operating system::network operating system
operating system network::operating system network
system network operating::system network operating
operating system runs::operating system runs
server the capability::server the capability
capability to manage::capability to manage
functions the primary::functions the primary
file and printer::file and printer
access among multiple::access among multiple
typically a local::typically a local
local area network::local area network
examples of network::examples of network
network operating systems::network operating systems
systems are microsoft::systems are microsoft
real time operating::real time operating
operating system real::operating system real
real time system::real time system
system is defines::system is defines
data processing system::data processing system
required to process::required to process
process and respond::process and respond
respond to inputs::respond to inputs
controls the environment::controls the environment
real time processing::real time processing
system to respond::system to respond
input and display::input and display
display of required::display of required
required updated information::required updated information
information is termed::information is termed
termed as response::termed as response
online processing real-time::online processing real-time
processing real-time systems::processing real-time systems
rigid time requirements::rigid time requirements
flow of data::flow of data
data and real-time::data and real-time
dedicated application real-time::dedicated application real-time
application real-time operating::application real-time operating
real-time operating system::real-time operating system
system has well-defined::system has well-defined
fixed time constraints::fixed time constraints
constraints otherwise system::constraints otherwise system
system will fail.for::system will fail.for
fail.for example scientific::fail.for example scientific
medical imaging systems::medical imaging systems
industrial control systems::industrial control systems
air traffic control::air traffic control
traffic control system::traffic control system
system etc operating::system etc operating
services an operating::services an operating
system provides services::system provides services
environment to execute::environment to execute
services to execute::services to execute
execute the programs::execute the programs
common services provided::common services provided
provided by operating::provided by operating
operating systems program::operating systems program
systems program execution::systems program execution
execution i operations::execution -NONE- operations
operations file system::operations file system
file system manipulation::file system manipulation
system manipulation communication::system manipulation communication
manipulation communication error::manipulation communication error
communication error detection::communication error detection
error detection resource::error detection resource
detection resource allocation::detection resource allocation
resource allocation protection::resource allocation protection
allocation protection operating::allocation protection operating
protection operating system::protection operating system
tasks that operating::tasks that operating
operating system handles::operating system handles
system handles batch::system handles batch
handles batch processing::handles batch processing
batch processing batch::batch processing batch
processing batch processing::processing batch processing
operating system collects::operating system collects
collects one programs::collects one programs
programs and data::programs and data
batch before processing::batch before processing
processing starts operating::processing starts operating
starts operating system::starts operating system
related to batch::related to batch
processing os defines::processing os defines
defines a job::defines a job
sequence of commands::sequence of commands
number a jobs::number a jobs
jobs in memory::jobs in memory
memory and executes::memory and executes
manual information jobs::manual information jobs
jobs are processed::jobs are processed
order of submission::order of submission
submission i.e first::submission i.e first
first served fashion::first served fashion
fashion when job::fashion when job
completes its execution::completes its execution
memory is released::memory is released
job gets copied::job gets copied
printing or processing::printing or processing
batch processing multitasking::batch processing multitasking
processing multitasking multitasking::processing multitasking multitasking
multitasking multitasking refers::multitasking multitasking refers
refers to term::refers to term
term where multiple::term where multiple
simultaneously by switching::simultaneously by switching
switching between them.switches::switching between them.switches
users may interact::users may interact
running multitasking multiprogramming::running multitasking multiprogramming
programs are residing::programs are residing
residing in memory::residing in memory
sharing the processor::sharing the processor
processor is referred::processor is referred
multiprogramming multiprogramming assumes::multiprogramming multiprogramming assumes
assumes a single::assumes a single
single shared processor::single shared processor
shared processor multiprogramming::shared processor multiprogramming
processor multiprogramming increases::processor multiprogramming increases
multiprogramming increases cpu::multiprogramming increases cpu
increases cpu utilization::increases cpu utilization
utilization by organizing::utilization by organizing
execute following figure::execute following figure
shows the memory::shows the memory
multiprogramming system memory::multiprogramming system memory
memory layout interactivity::memory layout interactivity
layout interactivity interactivity::layout interactivity interactivity
interactivity interactivity refers::interactivity interactivity refers
user is capable::user is capable
capable to interact::capable to interact
interact with computer::interact with computer
computer system operating::computer system operating
system operating system::system operating system
related to interactivity::related to interactivity
user an interface::user an interface
interface to interact::interface to interact
interact with system::interact with system
system os managers::system os managers
managers input devices::managers input devices
keyboard os manages::keyboard os manages
manages output devices::manages output devices
devices to show::devices to show
monitor os response::monitor os response
submits and waits::submits and waits
real time systems::real time systems
embedded systems operating::embedded systems operating
systems operating system::systems operating system
related to real::related to real
systems typically read::systems typically read
react to sensor::react to sensor
data the operating::data the operating
system must guarantee::system must guarantee
response to events::response to events
events within fixed::events within fixed
ensure correct performance::ensure correct performance
correct performance distributed::correct performance distributed
performance distributed environment::performance distributed environment
distributed environment distributed::distributed environment distributed
environment distributed environment::environment distributed environment
distributed environment refers::distributed environment refers
refers to multiple::refers to multiple
multiple independent cpus::multiple independent cpus
cpus or processors::cpus or processors
related to distributed::related to distributed
environment os distributes::environment os distributes
distributes computation logics::distributes computation logics
processors the processors::processors the processors
memory os manages::memory os manages
manages the communications::manages the communications
processors they communicate::processors they communicate
communication lines spooling::communication lines spooling
lines spooling spooling::lines spooling spooling
acronym for simultaneous::acronym for simultaneous
simultaneous peripheral operations::simultaneous peripheral operations
operations on line::operations on line
line spooling refers::line spooling refers
refers to putting::refers to putting
buffer this buffer::buffer this buffer
area in memory::area in memory
i devices operating::NNP devices operating
devices operating system::devices operating system
environment os handles::environment os handles
handles i device::handles JJ device
device data spooling::device data spooling
spooling as devices::spooling as devices
data access rates::data access rates
rates os maintains::rates os maintains
maintains the spooling::maintains the spooling
station where data::station where data
data can rest::data can rest
slower device catches::slower device catches
maintains parallel computation::maintains parallel computation
computer can perform::computer can perform
i in parallel::-NONE- in parallel
computer read data::computer read data
data to disk::data to disk
doing its computing::doing its computing
computing task spooling::computing task spooling
task spooling operating::task spooling operating
spooling operating system::spooling operating system
process a process::process a process
program in execution::program in execution
execution the execution::execution the execution
process must progress::process must progress
sequential fashion definition::sequential fashion definition
definition of process::definition of process
process is defined::process is defined
entity which represents::entity which represents
represents the basic::represents the basic
unit of work::unit of work
components of process::components of process
component & description::component & description
object program code::object program code
executing the program::executing the program
resources while executing::resources while executing
require some resources::require some resources
verifies the status::verifies the status
process execution.a process::process execution.a process
process can run::process can run
run to completion::run to completion
data and resources::data and resources
program a program::program a program
static entity made::static entity made
statement while process::statement while process
dynamic entity program::dynamic entity program
executed by processor::executed by processor
processor a program::processor a program
takes a space::takes a space
space at single::space at single
place in main::place in main
memory and continues::memory and continues
continues to stay::continues to stay
perform any action::perform any action
state the state::state the state
state & description::state & description
ready the process::ready the process
process is waiting::process is waiting
processor ready processes::processor ready processes
processes are waiting::processes are waiting
running process instructions::running process instructions
i.e the process::i.e the process
waiting the process::waiting the process
event to occur::event to occur
terminated the process::terminated the process
process has finished::process has finished
finished execution process::finished execution process
execution process states::execution process states
process states operating::process states operating
states operating system::states operating system
process scheduling definition::process scheduling definition
definition the process::definition the process
manager that handles::manager that handles
handles the removal::handles the removal
strategy process scheduling::strategy process scheduling
multiprogramming operating system::multiprogramming operating system
system such operating::system such operating
loaded process shares::loaded process shares
shares the cpu::shares the cpu
multiplexing scheduling queues::multiplexing scheduling queues
scheduling queues scheduling::scheduling queues scheduling
queues scheduling queues::queues scheduling queues
scheduling queues refers::scheduling queues refers
refers to queues::refers to queues
queues of processes::queues of processes
processes or devices::processes or devices
process is put::process is put
queue this queue::queue this queue
system the operating::system the operating
system also maintains::system also maintains
maintains other queues::maintains other queues
device queue device::device queue device
queue device queue::queue device queue
device each device::device each device
queue this figure::queue this figure
shows the queuing::shows the queuing
diagram of process::diagram of process
process scheduling queue::process scheduling queue
queue is represented::queue is represented
represented by rectangular::represented by rectangular
box the circles::box the circles
represent the resources::represent the resources
resources that serve::resources that serve
serve the queues::serve the queues
queues the arrows::queues the arrows
system queuing diagram::system queuing diagram
queuing diagram queues::queuing diagram queues
types ready queue::types ready queue
ready queue device::ready queue device
newly arrived process::newly arrived process
ready queue processes::ready queue processes
queue processes waits::queue processes waits
waits in ready::waits in ready
queue for allocating::queue for allocating
allocating the cpu::allocating the cpu
cpu is assigned::cpu is assigned
process will execute::process will execute
execute while executing::execute while executing
executing the process::executing the process
events can occur::events can occur
occur the process::occur the process
process could issue::process could issue
queue the process::queue the process
process could create::process could create
create new sub::create new sub
termination the process::termination the process
result of interrupt::result of interrupt
interrupt and put::interrupt and put
queue two state::queue two state
two state process::two state process
state process model::state process model
model two state::model two state
process model refers::process model refers
refers to running::refers to running
running and non-running::running and non-running
described below s.n::described below s.n
process is created::process is created
created by operating::created by operating
system that process::system that process
turn to execute::turn to execute
execute each entry::execute each entry
queue is implemented::queue is implemented
process is interrupted::process is interrupted
process is transferred::process is transferred
process has completed::process has completed
completed or aborted::completed or aborted
process is discarded::process is discarded
dispatcher then selects::dispatcher then selects
selects a process::selects a process
queue to execute::queue to execute
execute schedulers schedulers::execute schedulers schedulers
schedulers are special::schedulers are special
special system softwares::special system softwares
softwares which handles::softwares which handles
handles process scheduling::handles process scheduling
ways.their main task::ways.their main task
select the jobs::select the jobs
decide which process::decide which process
process to run::process to run
types long term::types long term
long term scheduler::long term scheduler
term scheduler short::term scheduler short
scheduler short term::scheduler short term
short term scheduler::short term scheduler
term scheduler medium::term scheduler medium
scheduler medium term::scheduler medium term
medium term scheduler::medium term scheduler
discuss four major::discuss four major
four major scheduling::four major scheduling
major scheduling algorithms::major scheduling algorithms
scheduling priority scheduling::scheduling priority scheduling
priority scheduling round::priority scheduling round
scheduling round robin::scheduling round robin
scheduling multilevel queue::scheduling multilevel queue
multilevel queue scheduling::multilevel queue scheduling
queue scheduling operating::queue scheduling operating
scheduling operating system::scheduling operating system
flow of execution::flow of execution
registers and stack::registers and stack
stack a thread::stack a thread
light weight process::light weight process
weight process threads::weight process threads
process threads provide::process threads provide
improve application performance::improve application performance
performance through parallelism::performance through parallelism
parallelism threads represent::parallelism threads represent
represent a software::represent a software
approach to improving::approach to improving
performance of operating::performance of operating
system by reducing::system by reducing
reducing the overhead::reducing the overhead
thread is equivalent::thread is equivalent
process each thread::process each thread
thread can exist::thread can exist
represents a separate::represents a separate
flow of control.threads::flow of control.threads
implementing network servers::implementing network servers
servers and web::servers and web
provide a suitable::provide a suitable
foundation for parallel::foundation for parallel
execution of applications::execution of applications
applications on shared::applications on shared
shared memory multiprocessors::shared memory multiprocessors
memory multiprocessors folowing::memory multiprocessors folowing
multiprocessors folowing figure::multiprocessors folowing figure
folowing figure shows::folowing figure shows
shows the working::shows the working
single and multithreaded::single and multithreaded
multithreaded processes single::multithreaded processes single
single vs multithreaded::single vs multithreaded
multithreaded process difference::multithreaded process difference
difference between process::difference between process
process and thread::process and thread
thread s.n process::thread s.n process
s.n process thread::s.n process thread
process is heavy::process is heavy
weight or resource::weight or resource
resource intensive thread::resource intensive thread
thread is light::thread is light
light weight taking::light weight taking
weight taking lesser::weight taking lesser
taking lesser resources::taking lesser resources
switching needs interaction::switching needs interaction
interaction with operating::interaction with operating
operating system thread::operating system thread
system thread switching::system thread switching
interact with operating::interact with operating
multiple processing environments::multiple processing environments
environments each process::environments each process
memory and file::memory and file
resources all threads::resources all threads
threads can share::threads can share
share same set::share same set
set of open::set of open
process is blocked::process is blocked
process can execute::process can execute
process is unblocked::process is unblocked
thread is blocked::thread is blocked
blocked and waiting::blocked and waiting
task can run::task can run
resources multiple threaded::resources multiple threaded
multiple threaded processes::multiple threaded processes
processes use fewer::processes use fewer
processes each process::processes each process
thread can read::thread can read
write or change::write or change
change another thread::change another thread
thread s data::thread s data
advantages of thread::advantages of thread
thread thread minimize::thread thread minimize
thread minimize context::thread minimize context
minimize context switching::minimize context switching
threads provides concurrency::threads provides concurrency
process efficient communication::process efficient communication
efficient communication economy::efficient communication economy-
economical to create::economical to create
create and context::create and context
context switch threads::context switch threads
switch threads utilization::switch threads utilization
utilization of multiprocessor::utilization of multiprocessor
scale and efficiency::scale and efficiency
types of thread::types of thread
threads are implemented::threads are implemented
two ways user::two ways user
ways user level::ways user level
user level threads::user level threads
user managed threads::user managed threads
managed threads kernel::managed threads kernel
threads kernel level::threads kernel level
kernel level threads::kernel level threads
operating system managed::operating system managed
system managed threads::system managed threads
managed threads acting::managed threads acting
acting on kernel::acting on kernel
operating system core::operating system core
memory management memory::memory management memory
management memory management::management memory management
system which handles::system which handles
handles or manages::handles or manages
manages primary memory::manages primary memory
primary memory memory::primary memory memory
memory memory management::memory memory management
management keeps track::management keeps track
free it checks::free it checks
allocated to processes::allocated to processes
processes it decides::processes it decides
decides which process::decides which process
memory gets freed::memory gets freed
freed or unallocated::freed or unallocated
correspondingly it updates::correspondingly it updates
updates the status::updates the status
status memory management::status memory management
management provides protection::management provides protection
register the base::register the base
base register holds::base register holds
holds the smallest::holds the smallest
smallest legal physical::smallest legal physical
legal physical memory::legal physical memory
physical memory address::physical memory address
limit register specifies::limit register specifies
specifies the size::specifies the size
access all addresses::access all addresses
memory management instructions::memory management instructions
instructions and data::instructions and data
data to memory::data to memory
process will reside::process will reside
compile time binding::compile time binding
generate the absolute::generate the absolute
absolute code load::absolute code load
reside in memory::reside in memory
compiler generates re-locatable::compiler generates re-locatable
generates re-locatable code::generates re-locatable code
re-locatable code execution::re-locatable code execution
done at run::done at run
run time dynamic::run time dynamic
loading in dynamic::loading in dynamic
program all routines::program all routines
re-locatable load format::re-locatable load format
format the main::format the main
program is loaded::program is loaded
loaded into memory::loaded into memory
executed other routines::executed other routines
methods or modules::methods or modules
modules are loaded::modules are loaded
loaded on request::loaded on request
request dynamic loading::request dynamic loading
dynamic loading makes::dynamic loading makes
makes better memory::makes better memory
memory space utilization::memory space utilization
utilization and unused::utilization and unused
loaded dynamic linking::loaded dynamic linking
dynamic linking linking::dynamic linking linking
process of collecting::process of collecting
collecting and combining::collecting and combining
combining various modules::combining various modules
modules of code::modules of code
code and data::code and data
memory and executed::memory and executed
executed operating system::executed operating system
system can link::system can link
link system level::link system level
system level libraries::system level libraries
combines the libraries::combines the libraries
libraries at load::libraries at load
linking is done::linking is done
linking in static::linking in static
linked at compile::linked at compile
program code size::program code size
size becomes bigger::size becomes bigger
dynamic linking libraries::dynamic linking libraries
linking libraries linked::linking libraries linked
linked at execution::linked at execution
code size remains::code size remains
size remains smaller::size remains smaller
remains smaller logical::remains smaller logical
smaller logical versus::smaller logical versus
logical versus physical::logical versus physical
versus physical address::versus physical address
physical address space::physical address space
space an address::space an address
address whereas address::address whereas address
physical address logical::physical address logical
address logical address::address logical address
virtual address virtual::virtual address virtual
virtual and physical::virtual and physical
compile-time and load-time::compile-time and load-time
load-time address-binding schemes::load-time address-binding schemes
address-binding schemes virtual::address-binding schemes virtual
physical addresses differ::physical addresses differ
differ in execution-time::differ in execution-time
execution-time address-binding scheme::execution-time address-binding scheme
scheme the set::scheme the set
logical addresses generated::logical addresses generated
program is referred::program is referred
logical address space::logical address space
space the set::space the set
addresses is referred::addresses is referred
space the run-time::space the run-time
mapping from virtual::mapping from virtual
virtual to physical::virtual to physical
address is done::address is done
memory management unit::memory management unit
hardware device mmu::hardware device mmu
mechanism to convert::mechanism to convert
convert virtual address::convert virtual address
address to physical::address to physical
address the value::address the value
register is added::register is added
treated as offset::treated as offset
base register value::base register value
reallocated to location::reallocated to location
user program deals::user program deals
deals with virtual::deals with virtual
sees the real::sees the real
real physical addresses::real physical addresses
physical addresses swapping::physical addresses swapping
addresses swapping swapping::addresses swapping swapping
out of main::out of main
back into memory::back into memory
memory for continued::memory for continued
continued execution backing::continued execution backing
execution backing store::execution backing store
hard disk drive::hard disk drive
fast in access::fast in access
access and large::access and large
capable of providing::capable of providing
providing direct access::providing direct access
memory images major::memory images major
major time consuming::major time consuming
part of swapping::part of swapping
swapping is transfer::swapping is transfer
transfer time total::transfer time total
amount of memory::amount of memory
standard hard disk::standard hard disk
disk with transfer::disk with transfer
milliseconds process swapping::milliseconds process swapping
process swapping memory::process swapping memory
swapping memory allocation::swapping memory allocation
memory allocation main::memory allocation main
allocation main memory::allocation main memory
two partitions low::two partitions low
partitions low memory::partitions low memory
operating system resides::operating system resides
memory high memory::memory high memory
processes then held::processes then held
held in high::held in high
high memory operating::high memory operating
memory operating system::memory operating system
memory allocation mechanism::memory allocation mechanism
allocation mechanism s.n::allocation mechanism s.n
mechanism s.n memory::mechanism s.n memory
s.n memory allocation::s.n memory allocation
memory allocation description::memory allocation description
type of allocation::type of allocation
protect user processes::protect user processes
changing operating-system code::changing operating-system code
data relocation register::data relocation register
register contains value::register contains value
value of smallest::value of smallest
smallest physical address::smallest physical address
address whereas limit::address whereas limit
register contains range::register contains range
range of logical::range of logical
addresses each logical::addresses each logical
memory is divided::memory is divided
number of fixed-sized::number of fixed-sized
partition is free::partition is free
process is selected::process is selected
fragmentation as processes::fragmentation as processes
processes are loaded::processes are loaded
loaded and removed::loaded and removed
removed from memory::removed from memory
free memory space::free memory space
space is broken::space is broken
allocated to memory::allocated to memory
size and memory::size and memory
memory blocks remains::memory blocks remains
blocks remains unused::blocks remains unused
unused this problem::unused this problem
two types s.n::two types s.n
types s.n fragmentation::types s.n fragmentation
s.n fragmentation description::s.n fragmentation description
external fragmentation total::external fragmentation total
fragmentation total memory::fragmentation total memory
total memory space::total memory space
satisfy a request::satisfy a request
reside a process::reside a process
internal fragmentation memory::internal fragmentation memory
fragmentation memory block::fragmentation memory block
memory block assigned::memory block assigned
assigned to process::assigned to process
process is bigger::process is bigger
bigger some portion::bigger some portion
portion of memory::portion of memory
memory is left::memory is left
process external fragmentation::process external fragmentation
reduced by compaction::reduced by compaction
compaction or shuffle::compaction or shuffle
shuffle memory contents::shuffle memory contents
contents to place::contents to place
place all free::place all free
block to make::block to make
make compaction feasible::make compaction feasible
dynamic paging external::dynamic paging external
paging external fragmentation::paging external fragmentation
fragmentation is avoided::fragmentation is avoided
paging technique paging::paging technique paging
memory is broken::memory is broken
broken into blocks::broken into blocks
size called pages::size called pages
size is power::size is power
pages are loaded::pages are loaded
memory frames logical::memory frames logical
frames logical address::frames logical address
process is allocated::process is allocated
allocated physical memory::allocated physical memory
free memory frame::free memory frame
system keeps track::system keeps track
free frames operating::free frames operating
frames operating system::frames operating system
frames to run::frames to run
run a program::run a program
program of size::program of size
size n pages::size n pages
pages address generated::pages address generated
generated by cpu::generated by cpu
cpu is divided::cpu is divided
divided into page::divided into page
page in physical::page in physical
physical memory page::physical memory page
memory page offset::memory page offset
offset is combined::offset is combined
combined with base::combined with base
address to define::address to define
define the physical::define the physical
memory address paging::memory address paging
paging following figure::paging following figure
show the paging::show the paging
paging table architecture::paging table architecture
table architecture paging::table architecture paging
paging example segmentation::paging example segmentation
technique to break::technique to break
memory into logical::memory into logical
represents a group::represents a group
group of related::group of related
segments or code::segments or code
segment for operating::segment for operating
paging unlike paging::paging unlike paging
eliminates internal fragmentation::eliminates internal fragmentation
internal fragmentation external::internal fragmentation external
fragmentation external fragmentation::fragmentation external fragmentation
fragmentation still exists::fragmentation still exists
lesser extent logical::lesser extent logical
extent logical address::extent logical address
address space address::address space address
space address generated::space address generated
divided into segment::divided into segment
segment in physical::segment in physical
limit of segment::limit of segment
segment segment offset::segment segment offset
offset is first::offset is first
checked against limit::checked against limit
memory address segmentation::memory address segmentation
segmentation example operating::segmentation example operating
virtual memory virtual::virtual memory virtual
memory virtual memory::memory virtual memory
execution of processes::execution of processes
memory the main::memory the main
main visible advantage::main visible advantage
larger than physical::larger than physical
physical memory virtual::physical memory virtual
separation of user::separation of user
user logical memory::user logical memory
memory from physical::memory from physical
memory this separation::memory this separation
extremely large virtual::extremely large virtual
large virtual memory::large virtual memory
provided for programmers::provided for programmers
smaller physical memory::smaller physical memory
fully in main::fully in main
main memory user::main memory user
memory user written::memory user written
user written error::user written error
written error handling::written error handling
error handling routines::error handling routines
data or computation::data or computation
computation certain options::computation certain options
options and features::options and features
rarely many tables::rarely many tables
tables are assigned::tables are assigned
assigned a fixed::assigned a fixed
amount of address::amount of address
ability to execute::ability to execute
execute a program::execute a program
partially in memory::partially in memory
memory would counter::memory would counter
counter many benefits::counter many benefits
benefits less number::benefits less number
needed to load::needed to load
load or swap::load or swap
swap each user::swap each user
program into memory::program into memory
memory a program::memory a program
longer be constrained::longer be constrained
amount of physical::amount of physical
increase in cpu::increase in cpu
utilization and throughput::utilization and throughput
throughput virtual memory::throughput virtual memory
implemented by demand::implemented by demand
segmentation system demand::segmentation system demand
system demand segmentation::system demand segmentation
provide virtual memory::provide virtual memory
virtual memory operating::virtual memory operating
hardware overview computers::hardware overview computers
overview computers operate::overview computers operate
kinds of devices::kinds of devices
devices general types::devices general types
general types include::general types include
types include storage::types include storage
include storage devices::include storage devices
specialized a device::specialized a device
system by sending::system by sending
air the device::air the device
connection point termed::connection point termed
termed a port::termed a port
set of wires::set of wires
bus.in other terms::bus.in other terms
rigidly defined protocol::rigidly defined protocol
protocol that specifies::protocol that specifies
specifies a set::specifies a set
set of messages::set of messages
wires daisy chain::wires daisy chain
chain when device::chain when device
cable that plugs::cable that plugs
plugs into device::plugs into device
device c plugs::device c plugs
controller a controller::controller a controller
collection of electronics::collection of electronics
operate a port::operate a port
device a serial-port::device a serial-port
simple device controller::simple device controller
computer that controls::computer that controls
controls the signals::controls the signals
port the scsi::port the scsi
scsi bus controller::scsi bus controller
separate circuit board::separate circuit board
memory to enable::memory to enable
process the scsi::process the scsi
scsi protocol messages::scsi protocol messages
messages some devices::messages some devices
controllers i port::controllers NNP port
port typically consists::port typically consists
data-out registers s.n::data-out registers s.n
registers s.n register::registers s.n register
register & description::register & description
register the status::register the status
register contains bits::register contains bits
host these bits::host these bits
bits indicate states::bits indicate states
command has completed::command has completed
register the control::register the control
host to start::host to start
start a command::start a command
change the mode::change the mode
device for instance::device for instance
serial port chooses::serial port chooses
chooses between full-duplex::chooses between full-duplex
full-duplex and half-duplex::full-duplex and half-duplex
enables parity checking::enables parity checking
sets the word::sets the word
register the data-in::register the data-in
register is read::register is read
register the data::register the data
data out register::data out register
register is written::register is written
host to send::host to send
send output polling::send output polling
output polling polling::output polling polling
waits for controller::waits for controller
reading the status::reading the status
bit of status::bit of status
register becomes clear::register becomes clear
clear the controller::clear the controller
uses the busy::NNS the busy
clears the busy::clears the busy
ready to accept::ready to accept
command the host::command the host
register the host::register the host
sets the command-ready::sets the command-ready
controller to execute::controller to execute
host writes output::host writes output
controller by handshaking::controller by handshaking
handshaking the host::handshaking the host
host repeatedly reads::host repeatedly reads
reads the busy::reads the busy
bit becomes clear::bit becomes clear
clear the host::clear the host
sets the write::sets the write
register and writes::register and writes
writes a byte::writes a byte
bit is set::bit is set
sets the busy::sets the busy
bit the controller::bit the controller
reads the command::reads the command
register and sees::register and sees
sees the write::sees the write
command it reads::command it reads
reads the data-out::reads the data-out
device the controller::device the controller
clears the command-ready::clears the command-ready
clears the error::clears the error
device i succeeded::device -NONE- succeeded
finished i devices::finished NNP devices
devices i devices::devices -NONE- devices
category s.n category::category s.n category
category & description::category & description
human readable human::human readable human
readable human readable::readable human readable
human readable devices::human readable devices
devices are suitable::devices are suitable
suitable for communicating::suitable for communicating
computer user examples::computer user examples
examples are printers::examples are printers
video display terminals::video display terminals
machine readable machine::machine readable machine
readable machine readable::readable machine readable
machine readable devices::machine readable devices
communicating with electronic::communicating with electronic
electronic equipment examples::electronic equipment examples
examples are disk::examples are disk
disk and tape::disk and tape
controllers and actuators::controllers and actuators
communication communication devices::communication communication devices
communicating with remote::communicating with remote
remote devices examples::remote devices examples
examples are digital::examples are digital
digital line drivers::digital line drivers
drivers and modems::drivers and modems
i devices s.n::NNP devices s.n
devices s.n criteria::devices s.n criteria
criteria & description::criteria & description
orders of magnitude::orders of magnitude
data transfer rates::data transfer rates
application different devices::application different devices
complexity of control::complexity of control
control a disk::control a disk
printer requires simple::printer requires simple
requires simple control::requires simple control
simple control interface::simple control interface
unit of transfer::unit of transfer
stream of bytes::stream of bytes
bytes or characters::bytes or characters
representation different data::representation different data
data encoding schemes::data encoding schemes
conditions the nature::conditions the nature
nature of errors::nature of errors
direct memory access::direct memory access
computers avoid burdening::computers avoid burdening
burdening the main::burdening the main
cpu with programmed::cpu with programmed
i by offloading::-NONE- by offloading
special purpose processor::special purpose processor
processor this type::processor this type
type of processor::type of processor
controller a special::controller a special
special control unit::special control unit
block of data::block of data
processor this approach::processor this approach
polling or interrupt::polling or interrupt
interrupt software dma::interrupt software dma
devices like disks::devices like disks
bytes of information::bytes of information
transferred in single::transferred in single
single i operations::single NN operations
cpu is notified::cpu is notified
byte or word::byte or word
provide the memory::provide the memory
bus signals controlling::bus signals controlling
controlling the data::controlling the data
data transfer interaction::data transfer interaction
controller is managed::controller is managed
device driver handshaking::device driver handshaking
performed via wires::performed via wires
wires using terms::wires using terms
terms dma request::terms dma request
request and dma::request and dma
dma acknowledge dma::dma acknowledge dma
acknowledge dma step::acknowledge dma step
dma step description::dma step description
driver is instructed::driver is instructed
instructed to transfer::instructed to transfer
transfer disk data::transfer disk data
driver then instruct::driver then instruct
instruct disk controller::instruct disk controller
controller to transfer::controller to transfer
data to buffer::data to buffer
disk controller starts::disk controller starts
controller starts dma::controller starts dma
starts dma transfer::starts dma transfer
disk controller sends::disk controller sends
sends each byte::sends each byte
byte to dma::byte to dma
dma controller transfers::dma controller transfers
controller transfers bytes::controller transfers bytes
bytes to buffer::bytes to buffer
increases the memory::increases the memory
decreases the counter::decreases the counter
dma interrupts cpu::dma interrupts cpu
cpu to signal::cpu to signal
signal transfer completion::signal transfer completion
transfer completion device::transfer completion device
completion device controllers::completion device controllers
controllers a computer::controllers a computer
respective controllers network::respective controllers network
controllers network card::controllers network card
network card graphics::network card graphics
card graphics adapter::card graphics adapter
graphics adapter disk::graphics adapter disk
adapter disk controller::adapter disk controller
disk controller dvd-rom::disk controller dvd-rom
controller dvd-rom controller::controller dvd-rom controller
dvd-rom controller serial::dvd-rom controller serial
controller serial port::controller serial port
serial port usb::serial port usb
port usb sound::port usb sound
usb sound card::usb sound card
sound card operating::sound card operating
card operating system::card operating system
interrupts the cpu::interrupts the cpu
interrupt request line::interrupt request line
request line wire::request line wire
wire which helps::wire which helps
cpu to sense::cpu to sense
sense after executing::sense after executing
executing every instruction::executing every instruction
controller has put::controller has put
put a signal::put a signal
saves a state::saves a state
interrupt handler routine::interrupt handler routine
address the interrupt::address the interrupt
interrupt handler part::interrupt handler part
handler part determines::handler part determines
processing and executes::processing and executes
executes a interrupt::executes a interrupt
instruction to return::instruction to return
return the cpu::return the cpu
state the basic::state the basic
mechanism of interrurpt::mechanism of interrurpt
enables the cpu::enables the cpu
cpu to respond::cpu to respond
ready for service::ready for service
service most cpus::service most cpus
two interrupt request::two interrupt request
interrupt request lines::interrupt request lines
request lines non-maskable::request lines non-maskable
lines non-maskable interrupt::lines non-maskable interrupt
kind of interrupts::kind of interrupts
interrupts are reserved::interrupts are reserved
reserved for events::reserved for events
events like unrecoverable::events like unrecoverable
unrecoverable memory errors::unrecoverable memory errors
memory errors maskable::memory errors maskable
errors maskable interrupt::errors maskable interrupt
execution of critical::execution of critical
interrupted the interrupt::interrupted the interrupt
interrupt mechanism accepts::interrupt mechanism accepts
accepts an address::accepts an address
number that selects::number that selects
selects a specific::selects a specific
specific interrupt handling::specific interrupt handling
set.in most architectures::set.in most architectures
interrupt vector table::interrupt vector table
table this vector::table this vector
addresses of specialized::addresses of specialized
specialized interrupt handlers::specialized interrupt handlers
interrupt handlers application::interrupt handlers application
application i interface::application -NONE- interface
i interface application::-NONE- interface application
i interface represents::-NONE- interface represents
represents the structuring::represents the structuring
techniques and interfaces::techniques and interfaces
system to enable::system to enable
enable i devices::enable NN devices
actual differences lies::actual differences lies
differences lies kernel::differences lies kernel
lies kernel level::lies kernel level
kernel level modules::kernel level modules
modules called device::modules called device
devices but show::devices but show
interfaces to applications::interfaces to applications
applications the purpose::applications the purpose
hide the differences::hide the differences
differences among device::differences among device
i system calls::NNP system calls
interfaces with respected::interfaces with respected
respected to devices::respected to devices
character-stream device transfers::character-stream device transfers
device transfers bytes::device transfers bytes
block device transfers::block device transfers
transfers a complete::transfers a complete
unit of bytes::unit of bytes
sequential device transfers::sequential device transfers
device transfers data::device transfers data
fixed order determined::fixed order determined
instructed to seek::instructed to seek
data storage locations::data storage locations
storage locations synchronous::storage locations synchronous
synchronous device performs::synchronous device performs
device performs data::device performs data
performs data transfers::performs data transfers
asynchronous device shows::asynchronous device shows
device shows irregular::device shows irregular
irregular or unpredictable::irregular or unpredictable
response time sharable::response time sharable
processes or threads::processes or threads
speed of operation::speed of operation
speeds may range::speeds may range
perform both input::perform both input
input and output::input and output
read only clocks::read only clocks
timers the clock::timers the clock
clock software takes::clock software takes
takes the form::takes the form
character based device::character based device
device the clock::device the clock
driver the exact::driver the exact
driver may vary::driver may vary
depending on operating::depending on operating
clock driver include::clock driver include
s.n task description::s.n task description
day the clock::day the clock
clock driver implements::clock driver implements
real time clock::real time clock
clock function.it requires::clock function.it requires
function.it requires incrementing::function.it requires incrementing
incrementing a counter::incrementing a counter
processes from running::processes from running
running too long::running too long
process is started::process is started
initializes the quantum::initializes the quantum
counter in clock::counter in clock
process the clock::process the clock
clock driver decrements::clock driver decrements
decrements the quantum::decrements the quantum
clock driver calls::clock driver calls
calls the scheduler::calls the scheduler
scheduler to set::scheduler to set
process thus clock::process thus clock
clock driver helps::clock driver helps
helps in preventing::helps in preventing
accounting for cpu::accounting for cpu
usage another function::usage another function
performed by clock::performed by clock
driver is doing::driver is doing
doing cpu accounting::doing cpu accounting
cpu accounting cpu::cpu accounting cpu
accounting cpu accounting::accounting cpu accounting
cpu accounting implies::cpu accounting implies
accounting implies telling::accounting implies telling
telling how long::telling how long
long the process::long the process
process has run::process has run
providing watchdog timers::providing watchdog timers
timers for parts::timers for parts
system itself watchdog::system itself watchdog
system must turn::system must turn
kernel i subsystem::kernel -NONE- subsystem
i subsystem kernel::-NONE- subsystem kernel
subsystem is responsible::subsystem is responsible
responsible to provide::responsible to provide
provide many services::provide many services
services provided scheduling::services provided scheduling
schedules a set::schedules a set
requests to determine::requests to determine
determine a good::determine a good
issues a blocking::issues a blocking
blocking i system::blocking NN system
device the kernel::device the kernel
kernel i scheduler::kernel -NONE- scheduler
i scheduler rearranges::-NONE- scheduler rearranges
rearranges the order::rearranges the order
queue to improve::queue to improve
response time experienced::response time experienced
i subsystem maintains::-NONE- subsystem maintains
maintains a memory::maintains a memory
buffer that stores::buffer that stores
application operation buffering::application operation buffering
buffering is done::buffering is done
done to cope::done to cope
producer and consumer::producer and consumer
adapt between devices::adapt between devices
data transfer sizes::data transfer sizes
transfer sizes caching::transfer sizes caching
kernel maintains cache::kernel maintains cache
maintains cache memory::maintains cache memory
region of fast::region of fast
memory that holds::memory that holds
copies of data::copies of data
efficient than access::efficient than access
spooling and device::spooling and device
reservation a spool::reservation a spool
buffer that holds::buffer that holds
accept interleaved data::accept interleaved data
interleaved data streams::interleaved data streams
streams the spooling::streams the spooling
spooling system copies::spooling system copies
copies the queued::copies the queued
queued spool files::queued spool files
spooling is managed::spooling is managed
system daemon process::system daemon process
kernel thread error::kernel thread error
thread error handling::thread error handling
handling an operating::handling an operating
memory can guard::memory can guard
kinds of hardware::kinds of hardware
hardware and application::hardware and application
application errors device::application errors device
errors device driver::errors device driver
device driver device::device driver device
driver device driver::driver device driver
program or routine::program or routine
device a device::device a device
device driver implements::device driver implements
implements i operations::implements -NONE- operations
operations or behaviours::operations or behaviours
class of devices::class of devices
number of multiple::number of multiple
brands of terminals::brands of terminals
slightly different terminals::slightly different terminals
single terminal driver::single terminal driver
device driver lies::device driver lies
lies between interrupt::lies between interrupt
handler and device::handler and device
independent i software::independent -NONE- software
software the job::software the job
device independent software::device independent software
request is executed::request is executed
operating system::operating system
computer hardware::computer hardware
execute programs::execute programs
technical terms::technical terms
manages hardware::manages hardware
system controls::system controls
information definition::information definition
conceptual view::conceptual view
important functions::important functions
system memory::system memory
memory management::memory management
management processor::management processor
processor management::processor management
management device::management device
device management::device management
management file::management file
file management::file management
management security::management security
security control::security control
system performance::system performance
performance job::performance job
job accounting::job accounting
accounting error::accounting error
error detecting::error detecting
detecting aids::detecting aids
aids coordination::aids coordination
users types::users types
system operating::system operating
operating systems::operating systems
first computer::first computer
computer generation::computer generation
generation operating::generation operating
important types::important types
batch operating::batch operating
computer directly::computer directly
user prepares::user prepares
off-line device::off-line device
punch cards::punch cards
computer operator::computer operator
programmers left::programmers left
sorts programs::sorts programs
similar requirements::similar requirements
batch systems::batch systems
job cpu::job cpu
cpu difficult::cpu difficult
desired priority::desired priority
priority time-sharing::priority time-sharing
time-sharing operating::time-sharing operating
computer system::computer system
logical extension::logical extension
multiprogramming processor::multiprogramming processor
multiple users::multiple users
main difference::main difference
multiprogrammed batch::multiprogrammed batch
time-sharing systems::time-sharing systems
maximize processor::maximize processor
minimize response::minimize response
multiple jobs::multiple jobs
switches occur::switches occur
transaction processing::transaction processing
processor execute::processor execute
user program::user program
short burst::short burst
user submits::user submits
system distributed::system distributed
distributed systems::distributed systems
central processors::central processors
serve multiple::serve multiple
multiple real::multiple real
users data::users data
data processing::data processing
processing jobs::processing jobs
processors communicate::processors communicate
communication lines::communication lines
high-speed buses::high-speed buses
telephone lines::telephone lines
coupled systems::coupled systems
systems processors::systems processors
distributed system::distributed system
network operating::network operating
system network::system network
system runs::system runs
manage data::manage data
networking functions::networking functions
primary purpose::primary purpose
printer access::printer access
multiple computers::multiple computers
local area::local area
area network::area network
private network::private network
networks examples::networks examples
microsoft windows::microsoft windows
novell netware::novell netware
system real::system real
processing system::processing system
interval required::interval required
line system::line system
updated information::updated information
method response::method response
online processing::online processing
processing real-time::processing real-time
real-time systems::real-time systems
control device::control device
dedicated application::dedicated application
application real-time::application real-time
real-time operating::real-time operating
scientific experiments::scientific experiments
medical imaging::medical imaging
imaging systems::imaging systems
industrial control::industrial control
control systems::control systems
weapon systems::weapon systems
home-applicance controllers::home-applicance controllers
air traffic::air traffic
traffic control::traffic control
control system::control system
convenient manner::convenient manner
common services::common services
services provided::services provided
systems program::systems program
program execution::program execution
file system::file system
system manipulation::system manipulation
manipulation communication::manipulation communication
communication error::communication error
error detection::error detection
detection resource::detection resource
resource allocation::resource allocation
allocation protection::allocation protection
protection operating::protection operating
important tasks::important tasks
system handles::system handles
handles batch::handles batch
processing batch::processing batch
batch processing::batch processing
system collects::system collects
processing starts::processing starts
starts operating::starts operating
activities related::activities related
predefined sequence::predefined sequence
single unit::single unit
manual information::manual information
information jobs::information jobs
i.e first::i.e first
served fashion::served fashion
job completes::job completes
output spool::output spool
processing multitasking::processing multitasking
multitasking multitasking::multitasking multitasking
multitasking refers::multitasking refers
them.switches occur::them.switches occur
running multitasking::running multitasking
multitasking multiprogramming::multitasking multiprogramming
multiprogramming multiprogramming::multiprogramming multiprogramming
multiprogramming assumes::multiprogramming assumes
shared processor::shared processor
processor multiprogramming::processor multiprogramming
multiprogramming increases::multiprogramming increases
increases cpu::increases cpu
cpu utilization::cpu utilization
organizing jobs::organizing jobs
figure shows::figure shows
multiprogramming system::multiprogramming system
layout interactivity::layout interactivity
interactivity interactivity::interactivity interactivity
interactivity refers::interactivity refers
managers input::managers input
input devices::input devices
manages output::manages output
output devices::output devices
show outputs::show outputs
systems represents::systems represents
embedded systems::embedded systems
systems operating::systems operating
system activity::system activity
sensor data::sensor data
guarantee response::guarantee response
fixed periods::fixed periods
correct performance::correct performance
performance distributed::performance distributed
distributed environment::distributed environment
environment distributed::environment distributed
environment refers::environment refers
independent cpus::independent cpus
distributes computation::distributes computation
computation logics::computation logics
physical processors::physical processors
share memory::share memory
local memory::local memory
lines spooling::lines spooling
spooling spooling::spooling spooling
simultaneous peripheral::simultaneous peripheral
peripheral operations::peripheral operations
line spooling::line spooling
spooling refers::spooling refers
putting data::putting data
special area::special area
devices operating::devices operating
activites related::activites related
device data::device data
data spooling::data spooling
data access::data access
access rates::access rates
spooling buffer::spooling buffer
waiting station::waiting station
slower device::slower device
device catches::device catches
parallel computation::parallel computation
spooling process::spooling process
parallel fashin::parallel fashin
computer read::computer read
read data::read data
write data::write data
tape printer::tape printer
computing task::computing task
task spooling::task spooling
spooling operating::spooling operating
processes process::processes process
sequential fashion::sequential fashion
fashion definition::fashion definition
basic unit::basic unit
system components::system components
s.n component::s.n component
object program::object program
program code::program code
data data::data data
status verifies::status verifies
process execution.a::process execution.a
execution.a process::execution.a process
requested resources::requested resources
resources program::resources program
static entity::static entity
entity made::entity made
program statement::program statement
dynamic entity::dynamic entity
entity program::entity program
program takes::program takes
single place::single place
main memory::main memory
process states::process states
process executes::process executes
current activity::current activity
process process::process process
s.n state::s.n state
processor ready::processor ready
ready processes::ready processes
processor allocated::processor allocated
running process::running process
process instructions::process instructions
finished execution::finished execution
execution process::execution process
states operating::states operating
process scheduling::process scheduling
scheduling definition::scheduling definition
process manager::process manager
strategy process::strategy process
essential part::essential part
multiprogramming operating::multiprogramming operating
executable memory::executable memory
loaded process::loaded process
process shares::process shares
multiplexing scheduling::multiplexing scheduling
scheduling queues::scheduling queues
queues scheduling::queues scheduling
queues refers::queues refers
process enters::process enters
job queue::job queue
queue consists::queue consists
device queue::device queue
queue device::queue device
multiple processes::multiple processes
queuing diagram::queuing diagram
scheduling queue::scheduling queue
rectangular box::rectangular box
circles represent::circles represent
process flow::process flow
system queuing::system queuing
diagram queues::diagram queues
arrived process::arrived process
ready queue::ready queue
queue processes::queue processes
processes waits::processes waits
sub process::sub process
state process::state process
process model::process model
model refers::model refers
non-running states::non-running states
running state::running state
running processes::running processes
process queue::process queue
linked list::linked list
waiting queue::waiting queue
execute schedulers::execute schedulers
schedulers schedulers::schedulers schedulers
special system::special system
system softwares::system softwares
handles process::handles process
ways.their main::ways.their main
main task::main task
run schedulers::run schedulers
term scheduler::term scheduler
short term::short term
scheduler medium::scheduler medium
medium term::medium term
scheduling algorithms::scheduling algorithms
major scheduling::major scheduling
scheduling priority::scheduling priority
priority scheduling::priority scheduling
scheduling round::scheduling round
round robin::round robin
scheduling multilevel::scheduling multilevel
multilevel queue::multilevel queue
queue scheduling::queue scheduling
scheduling operating::scheduling operating
process code::process code
program counter::program counter
system registers::system registers
light weight::light weight
weight process::weight process
process threads::process threads
threads provide::threads provide
improve application::improve application
application performance::application performance
parallelism threads::parallelism threads
threads represent::threads represent
software approach::software approach
improving performance::improving performance
overhead thread::overhead thread
classical process::classical process
thread belongs::thread belongs
thread represents::thread represents
separate flow::separate flow
implementing network::implementing network
network servers::network servers
web server::web server
suitable foundation::suitable foundation
parallel execution::parallel execution
shared memory::shared memory
memory multiprocessors::memory multiprocessors
multiprocessors folowing::multiprocessors folowing
folowing figure::folowing figure
multithreaded processes::multithreaded processes
multithreaded process::multithreaded process
process difference::process difference
thread s.n::thread s.n
s.n process::s.n process
process thread::process thread
heavy weight::heavy weight
resource intensive::resource intensive
intensive thread::intensive thread
weight taking::weight taking
taking lesser::taking lesser
lesser resources::lesser resources
process switching::process switching
system thread::system thread
thread switching::thread switching
multiple processing::multiple processing
processing environments::processing environments
file resources::file resources
open files::open files
child processes::child processes
first process::first process
resources multiple::resources multiple
multiple threaded::multiple threaded
threaded processes::threaded processes
fewer resources::fewer resources
process operates::process operates
data advantages::data advantages
thread thread::thread thread
thread minimize::thread minimize
minimize context::minimize context
context switching::context switching
process efficient::process efficient
efficient communication::efficient communication
communication economy::communication economy-
context switch::context switch
switch threads::switch threads
threads utilization::threads utilization
multiprocessor architectures::multiprocessor architectures
greater scale::greater scale
efficiency types::efficiency types
thread threads::thread threads
user level::user level
level threads::level threads
user managed::user managed
managed threads::managed threads
threads kernel::threads kernel
kernel level::kernel level
system managed::system managed
threads acting::threads acting
system core::system core
management memory::management memory
primary memory::primary memory
memory memory::memory memory
memory location::memory location
status memory::status memory
base register::base register
limit register::limit register
register holds::register holds
smallest legal::smallest legal
legal physical::legal physical
physical memory::physical memory
memory address::memory address
register specifies::register specifies
legally access::legally access
management instructions::management instructions
memory addresses::memory addresses
absolute code::absolute code
code load::code load
compiler generates::compiler generates
re-locatable code::re-locatable code
code execution::code execution
memory segment::memory segment
dynamic loading::dynamic loading
re-locatable load::re-locatable load
load format::load format
main program::main program
routines methods::routines methods
loading makes::loading makes
memory space::memory space
space utilization::space utilization
unused routines::unused routines
dynamic linking::dynamic linking
linking linking::linking linking
executable file::executable file
executed operating::executed operating
link system::link system
system level::system level
level libraries::level libraries
static linking::static linking
libraries linked::libraries linked
code size::code size
linking libraries::linking libraries
size remains::size remains
remains smaller::remains smaller
logical versus::logical versus
physical address::physical address
address space::address space
address generated::address generated
logical address::logical address
memory unit::memory unit
virtual address::virtual address
physical addresses::physical addresses
load-time address-binding::load-time address-binding
address-binding schemes::address-binding schemes
addresses differ::addresses differ
execution-time address-binding::execution-time address-binding
address-binding scheme::address-binding scheme
logical addresses::logical addresses
addresses generated::addresses generated
run-time mapping::run-time mapping
management unit::management unit
hardware device::hardware device
device mmu::device mmu
user process::user process
register value::register value
address location::address location
program deals::program deals
virtual addresses::virtual addresses
real physical::real physical
addresses swapping::addresses swapping
swapping swapping::swapping swapping
backing store::backing store
continued execution::continued execution
execution backing::execution backing
hard disk::hard disk
secondary storage::secondary storage
accommodate copies::accommodate copies
memory images::memory images
direct access::direct access
consuming part::consuming part
total transfer::total transfer
memory swapped::memory swapped
standard hard::standard hard
transfer rate::transfer rate
actual transfer::actual transfer
milliseconds process::milliseconds process
process swapping::process swapping
swapping memory::swapping memory
memory allocation::memory allocation
allocation main::allocation main
low memory::low memory
system resides::system resides
memory high::memory high
high memory::high memory
user processes::user processes
memory operating::memory operating
allocation mechanism::allocation mechanism
mechanism s.n::mechanism s.n
s.n memory::s.n memory
allocation description::allocation description
single-partition allocation::single-partition allocation
relocation-register scheme::relocation-register scheme
protect user::protect user
operating-system code::operating-system code
data relocation::data relocation
relocation register::relocation register
smallest physical::smallest physical
multiple-partition allocation::multiple-partition allocation
fixed-sized partitions::fixed-sized partitions
input queue::input queue
free partition::free partition
process terminates::process terminates
process fragmentation::process fragmentation
free memory::free memory
memory blocks::memory blocks
small size::small size
blocks remains::blocks remains
remains unused::remains unused
fragmentation fragmentation::fragmentation fragmentation
types s.n::types s.n
s.n fragmentation::s.n fragmentation
fragmentation description::fragmentation description
external fragmentation::external fragmentation
fragmentation total::fragmentation total
total memory::total memory
internal fragmentation::internal fragmentation
fragmentation memory::fragmentation memory
memory block::memory block
block assigned::block assigned
shuffle memory::shuffle memory
memory contents::memory contents
large block::large block
make compaction::make compaction
dynamic paging::dynamic paging
paging technique::paging technique
technique paging::technique paging
memory frames::memory frames
memory frame::memory frame
free frames::free frames
frames operating::frames operating
pages address::pages address
page number::page number
page table::page table
base address::base address
memory page::memory page
page offset::page offset
address paging::address paging
figure show::figure show
paging table::paging table
table architecture::table architecture
architecture paging::architecture paging
segmentation segmentation::segmentation segmentation
break memory::break memory
logical pieces::logical pieces
piece represents::piece represents
related information::related information
code segment::code segment
data segment::data segment
varying sizes::varying sizes
lesser extent::lesser extent
space address::space address
segment number::segment number
segment table::segment table
segment segment::segment segment
segment offset::segment offset
address segmentation::address segmentation
virtual memory::virtual memory
main visible::main visible
visible advantage::visible advantage
logical memory::logical memory
large virtual::large virtual
smaller physical::smaller physical
entire program::entire program
memory user::memory user
user written::user written
written error::written error
error handling::error handling
handling routines::handling routines
error occured::error occured
fixed amount::fixed amount
small amount::small amount
demand paging::demand paging
segmentation system::segmentation system
system demand::system demand
demand segmentation::demand segmentation
hardware overview::hardware overview
overview computers::overview computers
computers operate::computers operate
general types::general types
types include::types include
include storage::include storage
storage devices::storage devices
transmission devices::transmission devices
network cards::network cards
human-interface devices::human-interface devices
device communicates::device communicates
sending signals::sending signals
connection point::connection point
point termed::point termed
serial port::serial port
common set::common set
defined protocol::defined protocol
wires daisy::wires daisy
daisy chain::daisy chain
bus controller::bus controller
serial-port controller::serial-port controller
simple device::simple device
device controller::device controller
single chip::single chip
scsi bus::scsi bus
separate circuit::separate circuit
circuit board::circuit board
host adapter::host adapter
private memory::private memory
scsi protocol::scsi protocol
protocol messages::protocol messages
built-in controllers::built-in controllers
data-out registers::data-out registers
registers s.n::registers s.n
s.n register::s.n register
status register::status register
current command::current command
data-in register::data-in register
device error::device error
control register::control register
port chooses::port chooses
half-duplex communication::half-duplex communication
enables parity::enables parity
parity checking::parity checking
bit sets::bit sets
word length::word length
bits select::bits select
speeds supported::speeds supported
out register::out register
send output::send output
output polling::output polling
polling polling::polling polling
host waits::host waits
controller response.it::controller response.it
looping process::looping process
busy bit::busy bit
busy working::busy working
host signals::host signals
command-ready bit::command-ready bit
command register::command register
host sets::host sets
host writes::host writes
writes output::writes output
write bit::write bit
data-out register::data-out register
controller notices::controller notices
controller reads::controller reads
write command::write command
controller clears::controller clears
error bit::error bit
category s.n::category s.n
s.n category::s.n category
readable human::readable human
readable devices::readable devices
computer user::computer user
user examples::user examples
video display::video display
display terminals::display terminals
readable machine::readable machine
electronic equipment::electronic equipment
equipment examples::equipment examples
tape drives::tape drives
communication communication::communication communication
communication devices::communication devices
remote devices::remote devices
devices examples::devices examples
digital line::digital line
line drivers::line drivers
devices s.n::devices s.n
s.n criteria::s.n criteria
data rate::data rate
data transfer::data transfer
transfer rates::transfer rates
printer requires::printer requires
requires simple::requires simple
simple control::simple control
control interface::control interface
transfer data::transfer data
larger blocks::larger blocks
data representation::data representation
data encoding::data encoding
encoding schemes::encoding schemes
error conditions::error conditions
errors differs::errors differs
direct memory::direct memory
memory access::memory access
computers avoid::computers avoid
main cpu::main cpu
special purpose::special purpose
purpose processor::purpose processor
special control::special control
control unit::control unit
transfer block::transfer block
external device::external device
interrupt software::interrupt software
software dma::software dma
entire block::entire block
word transferred::word transferred
bus signals::bus signals
transfer interaction::transfer interaction
device driver::device driver
driver handshaking::driver handshaking
dma controller::dma controller
terms dma::terms dma
dma request::dma request
dma acknowledge::dma acknowledge
acknowledge dma::acknowledge dma
dma step::dma step
step description::step description
transfer disk::transfer disk
disk data::disk data
buffer address::buffer address
instruct disk::instruct disk
disk controller::disk controller
controller starts::controller starts
starts dma::starts dma
dma transfer::dma transfer
controller sends::controller sends
controller transfers::controller transfers
transfers bytes::transfers bytes
dma interrupts::dma interrupts
interrupts cpu::interrupts cpu
signal transfer::signal transfer
transfer completion::transfer completion
completion device::completion device
device controllers::device controllers
respective controllers::respective controllers
controllers network::controllers network
network card::network card
card graphics::card graphics
graphics adapter::graphics adapter
adapter disk::adapter disk
controller dvd-rom::controller dvd-rom
dvd-rom controller::dvd-rom controller
controller serial::controller serial
port usb::port usb
usb sound::usb sound
sound card::sound card
card operating::card operating
softwares interrupts::softwares interrupts
cpu hardware::cpu hardware
interrupt request::interrupt request
request line::request line
line wire::line wire
helps cpu::helps cpu
cpu checks::cpu checks
cpu saves::cpu saves
current value::current value
instruction pointer::instruction pointer
interrupt handler::interrupt handler
handler routine::handler routine
fixed address::fixed address
handler part::handler part
part determines::part determines
interrupt instruction::interrupt instruction
execution state::execution state
basic mechanism::basic mechanism
interrurpt enables::interrurpt enables
asynchronous event::asynchronous event
request lines::request lines
non-maskable interrupt::non-maskable interrupt
unrecoverable memory::unrecoverable memory
memory errors::memory errors
maskable interrupt::maskable interrupt
critical instructions::critical instructions
interrupt mechanism::interrupt mechanism
mechanism accepts::mechanism accepts
specific interrupt::specific interrupt
interrupt handling::interrupt handling
small set.in::small set.in
offset stored::offset stored
interrupt vector::interrupt vector
vector table::vector table
interrupt handlers::interrupt handlers
handlers application::handlers application
interface application::interface application
interface represents::interface represents
structuring techniques::structuring techniques
actual differences::actual differences
differences lies::differences lies
lies kernel::lies kernel
level modules::level modules
device drivers::device drivers
standard interfaces::standard interfaces
device-driver layer::device-driver layer
system calls::system calls
devices character-stream::devices character-stream
character-stream device::character-stream device
device transfers::device transfers
block device::block device
complete unit::complete unit
sequential device::sequential device
transfers data::transfers data
fixed order::fixed order
order determined::order determined
random-access device::random-access device
seek position::seek position
data storage::data storage
storage locations::storage locations
synchronous device::synchronous device
device performs::device performs
performs data::performs data
data transfers::data transfers
asynchronous device::asynchronous device
device shows::device shows
unpredictable response::unpredictable response
sharable device::sharable device
dedicated device::dedicated device
device speeds::device speeds
devices perform::devices perform
data direction::data direction
clocks clocks::clocks clocks
clock software::clock software
software takes::software takes
blocking device::blocking device
character based::character based
based device::based device
clock driver::clock driver
exact function::exact function
driver include::driver include
s.n task::s.n task
task description::task description
driver implements::driver implements
clock function.it::clock function.it
function.it requires::function.it requires
clock tick::clock tick
preventing processes::preventing processes
scheduler initializes::scheduler initializes
quantum counter::quantum counter
clock ticks::clock ticks
driver decrements::driver decrements
clock interrupt::clock interrupt
driver calls::driver calls
driver helps::driver helps
slice allowed::slice allowed
cpu usage::cpu usage
function performed::function performed
doing cpu::doing cpu
cpu accounting::cpu accounting
accounting cpu::accounting cpu
accounting implies::accounting implies
implies telling::implies telling
providing watchdog::providing watchdog
watchdog timers::watchdog timers
timers set::timers set
floppy disk::floppy disk
speed kernel::speed kernel
subsystem kernel::subsystem kernel
services related::services related
provided scheduling::provided scheduling
kernel schedules::kernel schedules
good order::good order
application issues::application issues
system call::system call
scheduler rearranges::scheduler rearranges
system efficiency::system efficiency
average response::average response
applications buffering::applications buffering
subsystem maintains::subsystem maintains
memory area::memory area
stores data::stores data
application operation::application operation
operation buffering::operation buffering
speed mismatch::speed mismatch
data stream::data stream
transfer sizes::transfer sizes
sizes caching::sizes caching
kernel maintains::kernel maintains
maintains cache::maintains cache
cache memory::cache memory
fast memory::fast memory
holds copies::holds copies
cached copy::cached copy
original spooling::original spooling
device reservation::device reservation
holds output::holds output
interleaved data::interleaved data
data streams::data streams
spooling system::spooling system
system copies::system copies
queued spool::queued spool
spool files::spool files
system daemon::system daemon
daemon process::daemon process
kernel thread::kernel thread
thread error::thread error
protected memory::protected memory
application errors::application errors
errors device::errors device
driver device::driver device
specific class::specific class
system supports::system supports
multiple brands::multiple brands
single terminal::single terminal
terminal driver::terminal driver
layered structure::layered structure
driver lies::driver lies
device independent::device independent
accept request::accept request
independent software::independent software
operating::operating
system::system
intermediary::intermediary
users::users
computer::computer
hardware::hardware
environment::environment
user::user
execute::execute
programs::programs
conveniently::conveniently
efficiently::efficiently
technical::technical
terms::terms
software::software
manages::manages
controls::controls
allocation::allocation
resources::resources
services::services
memory::memory
processors::processors
devices::devices
information::information
definition::definition
program::program
acts::acts
interface::interface
execution::execution
kinds::kinds
conceptual::conceptual
view::view
important::important
functions::functions
management::management
processor::processor
device::device
file::file
security::security
control::control
performance::performance
job::job
accounting::accounting
error::error
detecting::detecting
aids::aids
coordination::coordination
types::types
systems::systems
first::first
generation::generation
evolving::evolving
period::period
commonly::commonly
batch::batch
interact::interact
directly::directly
prepares::prepares
off-line::off-line
punch::punch
cards::cards
submits::submits
operator::operator
speed::speed
processing::processing
jobs::jobs
similar::similar
batched::batched
run::run
group::group
programmers::programmers
left::left
sorts::sorts
batches::batches
requirements::requirements
problems::problems
lack::lack
interaction::interaction
cpu::cpu
idle::idle
speeds::speeds
mechanical::mechanical
slower::slower
difficult::difficult
provide::provide
desired::desired
priority::priority
time-sharing::time-sharing
sharing::sharing
technique::technique
enables::enables
people::people
located::located
terminals::terminals
multitasking::multitasking
logical::logical
extension::extension
multiprogramming::multiprogramming
shared::shared
multiple::multiple
simultaneously::simultaneously
termed::termed
main::main
difference::difference
multiprogrammed::multiprogrammed
case::case
objective::objective
maximize::maximize
minimize::minimize
response::response
executed::executed
switching::switching
switches::switches
occur::occur
frequently::frequently
receives::receives
transaction::transaction
short::short
burst::burst
quantum::quantum
computation::computation
present::present
command::command
seconds::seconds
distributed::distributed
central::central
serve::serve
real::real
application::application
data::data
perform::perform
communicate::communicate
communication::communication
lines::lines
high-speed::high-speed
buses::buses
telephone::telephone
referred::referred
loosely::loosely
coupled::coupled
vary::vary
size::size
function::function
sites::sites
nodes::nodes
computers::computers
network::network
runs::runs
server::server
capability::capability
manage::manage
groups::groups
applications::applications
networking::networking
primary::primary
purpose::purpose
printer::printer
access::access
typically::typically
local::local
area::area
lan::lan
private::private
networks::networks
examples::examples
microsoft::microsoft
windows::windows
unix::unix
linux::linux
mac::mac
novell::novell
netware::netware
bsd::bsd
defines::defines
interval::interval
required::required
process::process
respond::respond
inputs::inputs
small::small
line::line
input::input
display::display
updated::updated
method::method
compared::compared
online::online
real-time::real-time
rigid::rigid
operation::operation
flow::flow
dedicated::dedicated
well-defined::well-defined
fixed::fixed
constraints::constraints
fail.for::fail.for
scientific::scientific
experiments::experiments
medical::medical
imaging::imaging
industrial::industrial
weapon::weapon
robots::robots
home-applicance::home-applicance
controllers::controllers
air::air
traffic::traffic
convenient::convenient
manner::manner
common::common
provided::provided
i::-NONE-
operations::operations
manipulation::manipulation
detection::detection
resource::resource
protection::protection
properties::properties
tasks::tasks
handles::handles
collects::collects
starts::starts
activities::activities
related::related
predefined::predefined
sequence::sequence
commands::commands
single::single
unit::unit
number::number
executes::executes
manual::manual
processed::processed
order::order
submission::submission
i.e::i.e
served::served
fashion::fashion
completes::completes
released::released
output::output
copied::copied
spool::spool
printing::printing
refers::refers
term::term
them.switches::them.switches
running::running
two::two
residing::residing
assumes::assumes
increases::increases
utilization::utilization
organizing::organizing
figure::figure
shows::shows
layout::layout
interactivity::interactivity
capable::capable
managers::managers
keyboard::keyboard
show::show
outputs::outputs
monitor::monitor
waits::waits
result::result
represents::represents
embedded::embedded
activity::activity
read::read
react::react
sensor::sensor
guarantee::guarantee
events::events
periods::periods
ensure::ensure
correct::correct
independent::independent
cpus::cpus
distributes::distributes
logics::logics
physical::physical
share::share
clock::clock
communications::communications
spooling::spooling
acronym::acronym
simultaneous::simultaneous
peripheral::peripheral
putting::putting
buffer::buffer
special::special
hard::hard
disk::disk
accessible::accessible
i::NNP
activites::activites
rates::rates
maintains::maintains
waiting::waiting
station::station
rest::rest
catches::catches
parallel::parallel
fashin::fashin
tape::tape
write::write
out::out
doing::doing
computing::computing
task::task
processes::processes
progress::progress
sequential::sequential
defined::defined
entity::entity
basic::basic
work::work
implemented::implemented
components::components
s.n::s.n
component::component
description::description
object::object
code::code
executing::executing
require::require
status::status
verifies::verifies
execution.a::execution.a
completion::completion
requested::requested
allocated::allocated
static::static
made::made
statement::statement
dynamic::dynamic
instructions::instructions
takes::takes
space::space
place::place
continues::continues
stay::stay
action::action
states::states
state::state
current::current
created::created
ready::ready
assigned::assigned
event::event
terminated::terminated
finished::finished
scheduling::scheduling
manager::manager
removal::removal
selection::selection
basis::basis
strategy::strategy
essential::essential
part::part
loaded::loaded
executable::executable
shares::shares
multiplexing::multiplexing
queues::queues
enters::enters
put::put
queue::queue
consists::consists
queuing::queuing
diagram::diagram
represented::represented
rectangular::rectangular
box::box
circles::circles
represent::represent
arrows::arrows
newly::newly
arrived::arrived
allocating::allocating
issue::issue
request::request
create::create
sub::sub
wait::wait
termination::termination
removed::removed
forcibly::forcibly
interrupt::interrupt
back::back
model::model
non-running::non-running
described::described
turn::turn
entry::entry
pointer::pointer
linked::linked
list::list
dispatcher::dispatcher
interrupted::interrupted
transferred::transferred
completed::completed
aborted::aborted
discarded::discarded
selects::selects
schedulers::schedulers
softwares::softwares
ways.their::ways.their
select::select
submitted::submitted
decide::decide
long::long
scheduler::scheduler
medium::medium
algorithms::algorithms
ll::ll
discuss::discuss
four::four
major::major
fcfs::fcfs
shortest-job-first::shortest-job-first
sjf::sjf
round::round
robin::robin
multilevel::multilevel
multi-threading::multi-threading
thread::thread
counter::counter
registers::registers
stack::stack
light::light
weight::weight
threads::threads
improve::improve
parallelism::parallelism
approach::approach
improving::improving
reducing::reducing
overhead::overhead
equivalent::equivalent
classical::classical
belongs::belongs
exist::exist
separate::separate
control.threads::control.threads
successfully::successfully
implementing::implementing
servers::servers
web::web
suitable::suitable
foundation::foundation
multiprocessors::multiprocessors
folowing::folowing
working::working
multithreaded::multithreaded
heavy::heavy
intensive::intensive
taking::taking
lesser::lesser
environments::environments
set::set
open::open
files::files
child::child
blocked::blocked
unblocked::unblocked
threaded::threaded
fewer::fewer
operates::operates
independently::independently
change::change
advantages::advantages
context::context
concurrency::concurrency
efficient::efficient
economy::economy-
economical::economical
switch::switch
multiprocessor::multiprocessor
architectures::architectures
greater::greater
scale::scale
efficiency::efficiency
ways::ways
level::level
managed::managed
kernel::kernel
acting::acting
core::core
functionality::functionality
track::track
location::location
free::free
checks::checks
decides::decides
tracks::tracks
freed::freed
unallocated::unallocated
correspondingly::correspondingly
updates::updates
base::base
register::register
limit::limit
holds::holds
smallest::smallest
legal::legal
address::address
specifies::specifies
range::range
legally::legally
addresses::addresses
done::done
compile::compile
reside::reside
binding::binding
generate::generate
absolute::absolute
load::load
compiler::compiler
generates::generates
re-locatable::re-locatable
moved::moved
segment::segment
delayed::delayed
loading::loading
routine::routine
routines::routines
format::format
methods::methods
modules::modules
makes::makes
unused::unused
linking::linking
collecting::collecting
combining::combining
link::link
libraries::libraries
combines::combines
bigger::bigger
remains::remains
smaller::smaller
versus::versus
generated::generated
virtual::virtual
compile-time::compile-time
load-time::load-time
address-binding::address-binding
schemes::schemes
differ::differ
execution-time::execution-time
scheme::scheme
run-time::run-time
mapping::mapping
mmu::mmu
mechanism::mechanism
convert::convert
value::value
added::added
treated::treated
offset::offset
attempt::attempt
dynamically::dynamically
reallocated::reallocated
deals::deals
sees::sees
swapping::swapping
swapped::swapped
temporarily::temporarily
backing::backing
store::store
brought::brought
continued::continued
drive::drive
secondary::secondary
storage::storage
fast::fast
large::large
accommodate::accommodate
copies::copies
images::images
providing::providing
direct::direct
consuming::consuming
transfer::transfer
total::total
proportional::proportional
amount::amount
assume::assume
100kb::100kb
standard::standard
rate::rate
actual::actual
100k::100k
1000kb::1000kb
milliseconds::milliseconds
partitions::partitions
low::low
resides::resides
high::high
held::held
single-partition::single-partition
type::type
relocation-register::relocation-register
protect::protect
changing::changing
operating-system::operating-system
relocation::relocation
multiple-partition::multiple-partition
divided::divided
fixed-sized::fixed-sized
partition::partition
selected::selected
terminates::terminates
fragmentation::fragmentation
broken::broken
pieces::pieces
blocks::blocks
problem::problem
external::external
satisfy::satisfy
contiguous::contiguous
internal::internal
block::block
portion::portion
reduced::reduced
compaction::compaction
shuffle::shuffle
contents::contents
make::make
feasible::feasible
paging::paging
avoided::avoided
pages::pages
power::power
bytes::bytes
frames::frames
non-contiguous::non-contiguous
frame::frame
page::page
index::index
table::table
combined::combined
define::define
architecture::architecture
segmentation::segmentation
break::break
piece::piece
,data::,data
segments::segments
unlike::unlike
varying::varying
sizes::sizes
eliminates::eliminates
exists::exists
extent::extent
checked::checked
completely::completely
visible::visible
advantage::advantage
larger::larger
separation::separation
extremely::extremely
situations::situations
entire::entire
fully::fully
written::written
handling::handling
occured::occured
options::options
features::features
rarely::rarely
tables::tables
ability::ability
partially::partially
benefits::benefits
needed::needed
swap::swap
longer::longer
constrained::constrained
increase::increase
throughput::throughput
demand::demand
overview::overview
operate::operate
general::general
include::include
disks::disks
tapes::tapes
transmission::transmission
modems::modems
human-interface::human-interface
screen::screen
mouse::mouse
specialized::specialized
communicates::communicates
sending::sending
signals::signals
cable::cable
machine::machine
connection::connection
point::point
port::port
serial::serial
wires::wires
bus.in::bus.in
bus::bus
rigidly::rigidly
protocol::protocol
messages::messages
daisy::daisy
chain::chain
plugs::plugs
arrangement::arrangement
controller::controller
collection::collection
electronics::electronics
serial-port::serial-port
simple::simple
chip::chip
scsi::scsi
circuit::circuit
board::board
host::host
adapter::adapter
microcode::microcode
enable::enable
built-in::built-in
data-in::data-in
data-out::data-out
bits::bits
byte::byte
start::start
mode::mode
instance::instance
bit::bit
chooses::chooses
full-duplex::full-duplex
half-duplex::half-duplex
parity::parity
checking::checking
sets::sets
word::word
length::length
supported::supported
send::send
polling::polling
response.it::response.it
looping::looping
reading::reading
busy::busy
clear::clear
uses::NNS
clears::clears
accept::accept
command-ready::command-ready
writes::writes
coordinating::coordinating
handshaking::handshaking
repeatedly::repeatedly
reads::reads
notices::notices
succeeded::succeeded
categorized::categorized
category::category
human::human
readable::readable
communicating::communicating
printers::printers
video::video
electronic::electronic
equipment::equipment
drives::drives
sensors::sensors
actuators::actuators
remote::remote
digital::digital
drivers::drivers
differences::differences
criteria::criteria
orders::orders
magnitude::magnitude
complexity::complexity
complex::complex
requires::requires
stream::stream
characters::characters
representation::representation
encoding::encoding
conditions::conditions
nature::nature
errors::errors
differs::differs
widely::widely
dma::dma
avoid::avoid
burdening::burdening
programmed::programmed
offloading::offloading
intervention::intervention
notified::notified
controlling::controlling
driver::driver
performed::performed
acknowledge::acknowledge
step::step
instructed::instructed
instruct::instruct
sends::sends
transfers::transfers
decreases::decreases
interrupts::interrupts
signal::signal
respective::respective
card::card
graphics::graphics
dvd-rom::dvd-rom
usb::usb
sound::sound
wire::wire
helps::helps
sense::sense
instruction::instruction
saves::saves
jumps::jumps
handler::handler
determines::determines
performs::performs
return::return
interrurpt::interrurpt
asynchronous::asynchronous
service::service
non-maskable::non-maskable
kind::kind
reserved::reserved
unrecoverable::unrecoverable
maskable::maskable
switched::switched
critical::critical
accepts::accepts
specific::specific
set.in::set.in
stored::stored
vector::vector
handlers::handlers
structuring::structuring
techniques::techniques
interfaces::interfaces
uniform::uniform
lies::lies
custom::custom
tailored::tailored
device-driver::device-driver
layer::layer
hide::hide
subsystem::subsystem
calls::calls
characteristics::characteristics
respected::respected
character-stream::character-stream
complete::complete
random-access::random-access
determined::determined
seek::seek
position::position
locations::locations
synchronous::synchronous
irregular::irregular
unpredictable::unpredictable
sharable::sharable
concurrently::concurrently
gigabytes::gigabytes
read-write::read-write
support::support
direction::direction
clocks::clocks
timers::timers
form::form
blocking::blocking
character::character
based::based
exact::exact
depending::depending
generally::generally
maintaining::maintaining
day::day
implements::implements
function.it::function.it
incrementing::incrementing
tick::tick
preventing::preventing
started::started
initializes::initializes
ticks::ticks
decrements::decrements
slice::slice
allowed::allowed
usage::usage
implies::implies
telling::telling
watchdog::watchdog
parts::parts
floppy::floppy
motor::motor
500msec::500msec
responsible::responsible
schedules::schedules
requests::requests
determine::determine
good::good
issues::issues
call::call
rearranges::rearranges
average::average
experienced::experienced
buffering::buffering
stores::stores
cope::cope
mismatch::mismatch
producer::producer
consumer::consumer
adapt::adapt
caching::caching
cache::cache
region::region
cached::cached
copy::copy
original::original
reservation::reservation
interleaved::interleaved
streams::streams
queued::queued
daemon::daemon
handled::handled
protected::protected
guard::guard
developed::developed
behaviours::behaviours
class::class
supports::supports
brands::brands
slightly::slightly
terminal::terminal
layered::layered
structure::structure
