languag it design philosophi::language its design philosophy
design philosophi emphas code::design philosophy emphasizes code
philosophi emphas code readabl::philosophy emphasizes code readability
programm to express concept::programmers to express concepts
concept in fewer line::concepts in fewer lines
fewer line of code::fewer lines of code
languag provid construct intend::language provides constructs intended
intend to enabl clear::intended to enable clear
small and larg scale::small and large scale
larg scale python support::large scale python supports
scale python support multipl::scale python supports multiple
python support multipl program::python supports multiple programming
support multipl program paradigm::supports multiple programming paradigms
imper and function program::imperative and functional programming
program or procedur style::programming or procedural styles
procedur style it featur::procedural styles it features
featur a dynam type::features a dynamic type
system and automat memori::system and automatic memory
larg and comprehens standard::large and comprehensive standard
comprehens standard librari python::comprehensive standard library python
standard librari python interpret::standard library python interpreters
instal on mani oper::installation on many operating
allow python code execut::allowing python code execution
wide varieti of system::wide variety of systems
system use third-parti tool::systems using third-party tools
code can be packag::code can be packaged
allow for the distribut::allowing for the distribution
distribut of python-bas softwar::distribution of python-based software
instal of a python::installation of a python
refer implement of python::reference implementation of python
free and open-sourc softwar::free and open-source software
implement cpython is manag::implementations cpython is managed
non-profit python softwar foundat::non-profit python software foundation
python softwar foundat python::python software foundation python
object-ori program and structur::object-oriented programming and structured
program and structur program::programming and structured programming
program are fulli support::programming are fully supported
number of languag featur::number of language features
languag featur which support::language features which support
program and aspect-ori program::programming and aspect-oriented programming
includ design by contract::including design by contract
contract and logic program::contract and logic programming
python use dynam type::python uses dynamic typing
type and a combin::typing and a combination
combin of refer count::combination of reference counting
garbag collector for memori::garbage collector for memory
collector for memori manag::collector for memory management
manag an import featur::management an important feature
import featur of python::important feature of python
method and variabl name::method and variable names
variabl name dure program::variable names during program
name dure program execut::names during program execution
program execut the design::program execution the design
design of python offer::design of python offers
python offer some support::python offers some support
support for function program::support for functional programming
program in the lisp::programming in the lisp
lisp tradit the languag::lisp tradition the language
set ; and gener::sets ; and generator
librari ha two modul::library has two modules
implement function tool borrow::implement functional tools borrowed
tool borrow from haskel::tools borrowed from haskell
standard ml the core::standard ml the core
philosophi of the languag::philosophy of the language
summar by the document::summarized by the document
count rather than requir::counts rather than requiring
requir all desir function::requiring all desired functionality
function to be built::functionality to be built
built into the languag::built into the language
embed in exist applic::embedded in existing applications
programm interfac thi design::programmable interface this design
extens interpret wa intend::extensible interpreter was intended
intend by van rossum::intended by van rossum
espous the opposit mindset::espoused the opposite mindset
offer choic in code::offering choice in coding
choic in code methodolog::choice in coding methodology
python philosophi reject exuber::python philosophy rejects exuberant
philosophi reject exuber syntax::philosophy rejects exuberant syntax
favor of a sparser::favor of a sparser
less-clutt grammar as alex::less-cluttered grammar as alex
grammar as alex put::grammar as alex put
describ someth as clever::describe something as clever
clever is not consid::clever is not considered
compliment in the python::compliment in the python
cultur python s philosophi::culture python s philosophy
python s philosophi reject::python s philosophy rejects
philosophi reject the perl::philosophy rejects the perl
approach to languag design::approach to language design
languag design in favor::language design in favor
python s develop strive::python s developers strive
develop strive to avoid::developers strive to avoid
strive to avoid prematur::strive to avoid premature
patch to non-crit part::patches to non-critical parts
non-crit part of cpython::non-critical parts of cpython
cpython which would offer::cpython which would offer
offer a margin increas::offer a marginal increase
margin increas in speed::marginal increase in speed
speed at the cost::speed at the cost
python programm use pypi::python programmers use pypy
time-crit function to extens::time-critical functions to extension
function to extens modul::functions to extension modules
modul written in languag::modules written in languages
translat a python script::translates a python script
make direct c level::makes direct c level
direct c level api::direct c level api
call into the python::calls into the python
interpret an import goal::interpreter an important goal
goal of the python::goal of the python
python develop is make::python developers is making
develop is make python::developers is making python
reflect in the origin::reflected in the origin
play approach to tutori::playful approach to tutorials
tutori and refer materi::tutorials and reference materials
standard foo and bar::standard foo and bar
bar a common neolog::bar a common neologism
neolog in the python::neologism in the python
wide rang of mean::wide range of meanings
rang of mean relat::range of meanings related
mean relat to program::meanings related to program
relat to program style::related to program style
natur or show fluenci::natural or shows fluency
fluenci in the languag::fluency in the language
python s minimalist philosophi::python s minimalist philosophy
minimalist philosophi and emphasi::minimalist philosophy and emphasis
transcript from anoth program::transcription from another programming
unpython user and admir::unpythonic users and admirers
python especi those consid::python especially those considered
consid knowledg or experienc::considered knowledgeable or experienced
experienc are often refer::experienced are often referred
refer to as pythonist::referred to as pythonists
syntax of the python::syntax of the python
languag is the set::language is the set
defin how a python::defines how a python
program will be written::program will be written
system and by human::system and by human
layout and use english::layout and uses english
frequent where other languag::frequently where other languages
languag use punctuat python::languages use punctuation python
python aim toward simplic::python aims towards simplicity
gener in the design::generality in the design
design of it syntax::design of its syntax
encapsul in the mantra::encapsulated in the mantra
whitespac to delimit program::whitespace to delimit program
off-sid rule python borrow::off-side rule python borrows
python borrow thi featur::python borrows this feature
featur from it predecessor::feature from its predecessor
run of a block::run of a block
structur deriv from algol::structure derived from algol
set off with brace::set off with braces
keyword in most code::keywords in most coding
convent for these languag::conventions for these languages
convent indent the code::conventionally indent the code
code within a block::code within a block
python mandat a convent::python mandates a convention
programm in algol-styl languag::programmers in algol-style languages
algol-styl languag often follow::algol-style languages often follow
enforc by an interpret::enforced by an interpreter
compil incorrectli indent code::compiler incorrectly indented code
code can be understood::code can be understood
understood by human reader::understood by human reader
type thi ha implic::type this has implications
implic for mani aspect::implications for many aspects
languag function all variabl::language functions all variables
variabl in python hold::variables in python hold
hold refer to object::hold references to objects
function ; a function::functions ; a function
function can not chang::function can not change
valu of variabl refer::value of variable references
refer in it call::references in its calling
includ guido van rossum::including guido van rossum
parameter-pass scheme " call::parameter-passing scheme " call
call by object refer::call by object reference
refer " an object::reference " an object
copi of the refer::copy of the reference
valu may be chang::value may be changed
rang of basic data::range of basic data
basic data type alongsid::basic data types alongside
type alongsid convent integ::types alongside conventional integer
convent integ and float::conventional integer and floating
integ and float point::integer and floating point
decim float point number::decimal floating point numbers
float point number python::floating point numbers python
point number python support::point numbers python supports
support a wide varieti::supports a wide variety
wide varieti of string::wide variety of string
varieti of string oper::variety of string operations
oper string in python::operations strings in python
program languag might alter::programming languages might alter
return a new string::returns a new string
string in python perform::string in python performance
perform consider sometim push::performance considerations sometimes push
special techniqu in program::special techniques in programs
program that modifi string::programs that modify strings
charact array into string::character arrays into strings
string onli as need::strings only as needed
python is the concept::python is the concept
collect is an object::collection is an object
easili referenc or index::easily referenced or indexed
referenc or index collect::referenced or indexed collections
sequenti type are list::sequential types are lists
make them perfect candid::making them perfect candidates
candid for dictionari key::candidates for dictionary keys
element can be insert::elements can be inserted
implement in the form::implemented in the form
dictionari which " map::dictionaries which " map
map " a set::map " a set
set of immut key::set of immutable keys
key to correspond element::keys to corresponding elements
dictionari have a string::dictionary having a string
map to the integ::mapped to the integer
vice versa the key::vice versa the keys
integ or a string::integer or a string
hood they are implement::hood they are implemented
implement via a hash::implemented via a hash
hash function thi make::hash function this makes
requir key not chang::requires keys not change
central to the intern::central to the internals
intern of the languag::internals of the language
languag as they resid::language as they reside
resid at the core::reside at the core
core of all python::core of all python
python object and class::python objects and classes
map between variabl name::mappings between variable names
valu which the name::values which the names
name refer are store::names reference are stored
metaprogram is a straightforward::metaprogramming is a straightforward
straightforward and natur process::straightforward and natural process
natur process in python::natural process in python
python a set collect::python a set collection
collect type wa ad::collection type was added
ad to the core::added to the core
core languag in version::core language in version
set is an unindex::set is an unindexed
oper such as union::operations such as union
two type of set::two types of sets
differ be that set::difference being that set
frozenset is immut element::frozenset is immutable elements
element in a set::elements in a set
opposit is not true::opposite is not true
extens collect manipul abil::extensive collection manipulating abilities
abil such as built::abilities such as built
built in contain check::built in containment checking
gener iter protocol python::generic iteration protocol python
greatest strengths,provid tool suit::greatest strengths,providing tools suited
suit to mani task::suited to many tasks
batteri includ " python::batteries included " python
includ " python philosophi::included " python philosophy
philosophi for internet-fac applic::philosophy for internet-facing applications
number of standard format::number of standard formats
standard format and protocol::standard formats and protocols
support modul for creat::supported modules for creating
creat graphic user interfac::creating graphical user interfaces
connect to relat databas::connecting to relational databases
arithmet with arbitrari precis::arithmetic with arbitrary precision
test are also includ::testing are also included
standard librari are cover::standard library are covered
wsgi implement follow pep::wsgi implementation follows pep
major of the modul::majority of the modules
librari is cross-platform python::library is cross-platform python
alter or complet rewritten::altered or completely rewritten
rewritten by altern implement::rewritten by alternative implementations
implement the standard librari::implementations the standard library
essenti to run python::essential to run python
run python or emb::run python or embed
python or emb python::python or embed python
python within an applic::python within an application
repositori of third-parti softwar::repository of third-party software
third-parti softwar for python::third-party software for python
offer a wide rang::offering a wide range
wide rang of function::wide range of functionality
commun * test framework::communications * test frameworks
autom and web scrape::automation and web scraping
administr * scientif comput::administration * scientific computing
imag process most python::image processing most python
process most python implement::processing most python implementations
function as a command::function as a command
statement sequenti and receiv::statements sequentially and receives
shell.oth shell add capabl::shell.other shells add capabilities
includ idl and ipython::including idle and ipython
style of the python::style of the python
implement featur like auto-complet::implement features like auto-completion
retent of session state::retention of session state
highlighting.in addit to standard::highlighting.in addition to standard
standard desktop python ide::standard desktop python ides
intend for develop scienc::intended for developing science
scienc and math-rel python::science and math-related python
browser-bas ide and host::browser-based ide and hosting
ide and host environ::ide and hosting environment
pythonanywher the main python::pythonanywhere the main python
written in c meet::written in c meeting
meet the c89 standard::meeting the c89 standard
c89 standard it compil::c89 standard it compiles
standard it compil python::standard it compiles python
program into intermedi bytecod::programs into intermediate bytecode
machin cpython is distribut::machine cpython is distributed
larg standard librari written::large standard library written
written in a mixtur::written in a mixture
version for mani platform::versions for many platforms
modern unix-lik system cpython::modern unix-like systems cpython
system cpython wa intend::systems cpython was intended
concept to be cross-platform::conception to be cross-platform
compliant interpret of python::compliant interpreter of python
bring a signific speed::brings a significant speed
speed improv over cpython::speed improvement over cpython
cpython a version take::cpython a version taking
advantag of multi-cor processor::advantage of multi-core processors
multi-cor processor use softwar::multi-core processors using software
memori is be creat::memory is being created
signific fork of cpython::significant fork of cpython
cpython that implement microthread::cpython that implements microthreads
allow massiv concurr program::allowing massively concurrent programs
massiv concurr program pypi::massively concurrent programs pypy
compil have been develop::compilers have been developed
googl start a project::google started a project
project call unladen swallow::project called unladen swallow
speed of the python::speed of the python
improv it multithread abil::improving its multithreading ability
multithread abil to scale::multithreading ability to scale
core later the project::cores later the project
lost googl s back::lost google s backing
time faster than cpython::times faster than cpython
psyco is a specialis::psyco is a specialising
cpython and transform bytecod::cpython and transforms bytecode
transform bytecod to machin::transforms bytecode to machine
bytecod to machin code::bytecode to machine code
machin code at runtim::machine code at runtime
runtim the produc code::runtime the produced code
produc code is specialis::produced code is specialised
specialis for certain data::specialised for certain data
faster than standard python::faster than standard python
nokia releas a python::nokia released a python
releas a python interpret::released a python interpreter
interpret for the seri::interpreter for the series
mobil phone call pys60::mobile phones called pys60
modul from the cpython::modules from the cpython
addit modul for integr::additional modules for integration
oper system thi project::operating system this project
run on all variant::run on all variants
variant of the s60::variants of the s60
modul avail the nokia::modules available the nokia
nokia n900 also support::nokia n900 also supports
n900 also support python::n900 also supports python
support python with gtk::supports python with gtk
python with gtk widget::python with gtk widget
run on the devic::run on the device
compil to high-level object::compilers to high-level object
restrict subset of python::restricted subset of python
languag similar to python::language similar to python
python as the sourc::python as the source
jython compil into java::jython compiles into java
compil into java byte::compiles into java byte
execut by everi java::executed by every java
java virtual machin implement::java virtual machine implementation
implement thi also enabl::implementation this also enables
java class librari function::java class library functions
function from the python::functions from the python
similar approach in order::similar approach in order
order to run python::order to run python
.net common languag runtim::.net common language runtime
languag runtim the rpython::language runtime the rpython
runtim the rpython languag::runtime the rpython language
languag can be compil::language can be compiled
build the pypi interpret::build the pypy interpreter
pypi interpret of python::pypy interpreter of python
interpret of python pyjama::interpreter of python pyjamas
python pyjama compil python::python pyjamas compiles python
compil python to javascript.cython::compiles python to javascript.cython
javascript.cython and pyrex compil::javascript.cython and pyrex compile
comparison of variou python::comparison of various python
present at euroscipi 13::presented at euroscipy 13
13 python s develop::13 python s development
larg through the python::largely through the python
process the pep process::process the pep process
primari mechan for propos::primary mechanism for proposing
propos major new featur::proposing major new features
input on an issu::input on an issue
document the design decis::documenting the design decisions
outstand pep are review::outstanding peps are reviewed
commun and by van::community and by van
python project s bdfl::python project s bdfl
project s bdfl enhanc::project s bdfl enhancement
enhanc of the languag::enhancement of the language
develop of the cpython::development of the cpython
refer implement the mail::reference implementation the mailing
implement the mail list::implementation the mailing list
primari forum for discuss::primary forum for discussion
discuss about the languag::discussion about the language
develop ; specif issu::development ; specific issues
specif issu are discuss::specific issues are discussed
discuss in the roundup::discussed in the roundup
roundup bug tracker maintain::roundup bug tracker maintained
tracker maintain at python.org::tracker maintained at python.org
maintain at python.org develop::maintained at python.org development
python.org develop take place::python.org development takes place
self-host sourc code repositori::self-hosted source code repository
sourc code repositori run::source code repository running
code repositori run mercuri::code repository running mercurial
repositori run mercuri cpython::repository running mercurial cpython
cpython s public releas::cpython s public releases
distinguish by which part::distinguished by which part
part of the version::part of the version
version number is increment::version number is incremented
port the first part::ported the first part
increment these releas happen::incremented these releases happen
major or " featur::major or " feature
larg compat but introduc::largely compatible but introduce
featur the second part::features the second part
major version is support::major version is supported
bugfix for sever year::bugfixes for several years
year after it releas::years after its release
releas * bugfix releas::release * bugfix releases
introduc no new featur::introduce no new features
featur but fix bug::features but fix bugs
made whenev a suffici::made whenever a sufficient
suffici number of bug::sufficient number of bugs
bug have been fix::bugs have been fixed
vulner are also patch::vulnerabilities are also patched
patch in bugfix releas::patched in bugfix releases
bugfix releas a number::bugfix releases a number
release-candid are also releas::release-candidates are also released
preview and for test::previews and for testing
final releas is made::final release is made
schedul for each releas::schedule for each release
back if the code::back if the code
code is not readi::code is not ready
readi the develop team::ready the development team
team monitor the state::team monitor the state
state of the code::state of the code
run the larg unit::running the large unit
unit testsuit dure develop::unit testsuite during development
buildbot continu integr system::buildbot continuous integration system
integr system the commun::integration system the community
commun of python develop::community of python developers
develop ha also contribut::developers has also contributed
contribut over 58,000 softwar::contributed over 58,000 software
modul to the python::modules to the python
repositori of third-parti librari::repository of third-party libraries
third-parti librari for python::third-party libraries for python
academ confer on python::academic conference on python
programm like the pyladi::programmes like the pyladies
pyladi the except class::pyladies the exception classes
except class are defin::exception classes are defined
librari document in addit::library documentation in addition
except can be caught::exceptions can be caught
catch their base class::catching their base class
class in most case::class in most cases
class are not intend::classes are not intended
intend to be rais::intended to be raised
rais directli baseexcept base::raised directly baseexception base
directli baseexcept base class::directly baseexception base class
class for all except::class for all exceptions
implement logic for creat::implements logic for creating
creat a string represent::creating a string representation
represent of the except::representation of the exception
pass to the constructor::passed to the constructor
constructor except base class::constructor exception base class
base class for except::base class for exceptions
quit the run applic::quitting the running application
applic all user-defin except::application all user-defined exceptions
except should use except::exceptions should use exception
except as a base::exception as a base
base class standarderror base::base class standarderror base
class standarderror base class::class standarderror base class
class for built-in except::class for built-in exceptions
standard librari arithmeticerror base::standard library arithmeticerror base
librari arithmeticerror base class::library arithmeticerror base class
class for math-rel error::class for math-related errors
math-rel error lookuperror base::math-related errors lookuperror base
error lookuperror base class::errors lookuperror base class
base class for error::base class for errors
class for error rais::class for errors raised
found environmenterror base class::found environmenterror base class
rais by a fail::raised by a failed
simplest way to handl::simplest way to handle
claus and a user::clause and a user
gener a keyboard interrupt::generating a keyboard interrupt
nt want the program::nt want the program
suppos you are write::suppose you are writing
write an extens modul::writing an extension module
modul to a web::module to a web
error inform to output::error information to output
output the output web::output the output web
put in your code::put in your code
error catch is good::error catching is good
good if you write::good if you write
write moinmoin extens macro::write moinmoin extension macros
report of your error::report of your error
error and the chain::error and the chain
chain of event lead::chain of events leading
recipi of the web::recipient of the web
wide use general-purpos::widely used general-purpose
languag it design::language its design
design philosophi emphas::design philosophy emphasizes
philosophi emphas code::philosophy emphasizes code
emphas code readabl::emphasizes code readability
syntax allow programm::syntax allows programmers
programm to express::programmers to express
concept in fewer::concepts in fewer
line of code::lines of code
java the languag::java the language
languag provid construct::language provides constructs
intend to enabl::intended to enable
enabl clear program::enable clear programs
small and larg::small and large
larg scale python::large scale python
scale python support::scale python supports
python support multipl::python supports multiple
support multipl program::supports multiple programming
multipl program paradigm::multiple programming paradigms
imper and function::imperative and functional
program or procedur::programming or procedural
style it featur::styles it features
featur a dynam::features a dynamic
dynam type system::dynamic type system
system and automat::system and automatic
automat memori manag::automatic memory management
larg and comprehens::large and comprehensive
comprehens standard librari::comprehensive standard library
standard librari python::standard library python
librari python interpret::library python interpreters
allow python code::allowing python code
python code execut::python code execution
varieti of system::variety of systems
system use third-parti::systems using third-party
py2ex or pyinstal::py2exe or pyinstaller
packag into stand-alon::packaged into stand-alone
stand-alon execut program::stand-alone executable programs
popular oper system::popular operating systems
distribut of python-bas::distribution of python-based
environ without requir::environments without requiring
requir the instal::requiring the installation
python interpret cpython::python interpreter cpython
implement of python::implementation of python
free and open-sourc::free and open-source
community-bas develop model::community-based development model
altern implement cpython::alternative implementations cpython
cpython is manag::cpython is managed
non-profit python softwar::non-profit python software
python softwar foundat::python software foundation
softwar foundat python::software foundation python
multi-paradigm program languag::multi-paradigm programming language
program and structur::programming and structured
number of languag::number of language
featur which support::features which support
support function program::support functional programming
program and aspect-ori::programming and aspect-oriented
includ by metaprogram::including by metaprogramming
paradigm are support::paradigms are supported
support use extens::supported using extensions
design by contract::design by contract
contract and logic::contract and logic
logic program python::logic programming python
python use dynam::python uses dynamic
combin of refer::combination of reference
cycle-detect garbag collector::cycle-detecting garbage collector
collector for memori::collector for memory
manag an import::management an important
featur of python::feature of python
python is dynam::python is dynamic
dynam name resolut::dynamic name resolution
method and variabl::method and variable
name dure program::names during program
execut the design::execution the design
design of python::design of python
offer some support::offers some support
support for function::support for functional
tradit the languag::tradition the language
languag ha map::language has map
function ; comprehens::functions ; comprehensions
comprehens for list::comprehensions for lists
itertool and functool::itertools and functools
implement function tool::implement functional tools
function tool borrow::functional tools borrowed
borrow from haskel::borrowed from haskell
haskel and standard::haskell and standard
languag is summar::language is summarized
document " pep::document " pep
zen of python::zen of python
requir all desir::requiring all desired
languag s core::language s core
python wa design::python was designed
highli extens python::highly extensible python
embed in exist::embedded in existing
interfac thi design::interface this design
small core languag::small core language
larg standard librari::large standard library
easili extens interpret::easily extensible interpreter
interpret wa intend::interpreter was intended
intend by van::intended by van
frustrat with abc::frustrations with abc
espous the opposit::espoused the opposite
choic in code::choice in coding
python philosophi reject::python philosophy rejects
philosophi reject exuber::philosophy rejects exuberant
reject exuber syntax::rejects exuberant syntax
grammar as alex::grammar as alex
consid a compliment::considered a compliment
python cultur python::python culture python
python s philosophi::python s philosophy
reject the perl::rejects the perl
approach to languag::approach to language
design in favor::design in favor
python s develop::python s developers
strive to avoid::strive to avoid
avoid prematur optim::avoid premature optimization
patch to non-crit::patches to non-critical
part of cpython::parts of cpython
offer a margin::offer a marginal
increas in speed::increase in speed
cost of clariti::cost of clarity
speed is import::speed is important
programm use pypi::programmers use pypy
move time-crit function::move time-critical functions
function to extens::functions to extension
extens modul written::extension modules written
written in languag::written in languages
translat a python::translates a python
direct c level::direct c level
level api call::level api calls
interpret an import::interpreter an important
develop is make::developers is making
make python fun::making python fun
occasion play approach::occasionally playful approach
approach to tutori::approach to tutorials
tutori and refer::tutorials and reference
spam and egg::spam and eggs
foo and bar::foo and bar
bar a common::bar a common
commun is python::community is pythonic
rang of mean::range of meanings
relat to program::related to program
code is python::code is pythonic
natur or show::natural or shows
conform with python::conforms with python
python s minimalist::python s minimalist
philosophi and emphasi::philosophy and emphasis
emphasi on readabl::emphasis on readability
readabl in contrast::readability in contrast
difficult to understand::difficult to understand
understand or read::understand or reads
user and admir::users and admirers
admir of python::admirers of python
knowledg or experienc::knowledgeable or experienced
python the syntax::pythoneers the syntax
python program languag::python programming language
set of rule::set of rules
rule that defin::rules that defines
written and interpret::written and interpreted
.python wa design::.python was designed
highli readabl language.it::highly readable language.it
languag use punctuat::languages use punctuation
punctuat python aim::punctuation python aims
aim toward simplic::aims towards simplicity
simplic and gener::simplicity and generality
python " .python::python " .python
.python use whitespac::.python uses whitespace
whitespac to delimit::whitespace to delimit
delimit program block::delimit program blocks
off-sid rule python::off-side rule python
rule python borrow::rule python borrows
borrow thi featur::borrows this feature
punctuat or keyword::punctuation or keywords
block in so-cal::block in so-called
so-cal " free-format::so-called " free-format
free-format " languag::free-format " languages
block structur deriv::block structure derived
deriv from algol::derived from algol
block of code::blocks of code
code are set::code are set
programm convent indent::programmers conventionally indent
indent the code::indent the code
mandat a convent::mandates a convention
convent that programm::convention that programmers
programm in algol-styl::programmers in algol-style
languag often follow::languages often follow
interpret or compil::interpreter or compiler
compil incorrectli indent::compiler incorrectly indented
incorrectli indent code::incorrectly indented code
understood by human::understood by human
compil or interpret::compiler or interpreter
interpret sinc python::interpreter since python
dynam type languag::dynamically typed language
function all variabl::functions all variables
variabl in python::variables in python
python hold refer::python hold references
refer to object::references to objects
refer are pass::references are passed
pass to function::passed to functions
chang the valu::change the value
valu of variabl::value of variable
includ guido van::including guido van
guido van rossum::guido van rossum
scheme " call::scheme " call
call by object::call by object
object refer mean::object reference means
i.e a copi::i.e a copy
object s valu::object s value
rang of basic::range of basic
basic data type::basic data types
data type alongsid::data types alongside
type alongsid convent::types alongside conventional
alongsid convent integ::alongside conventional integer
integ and float::integer and floating
float point arithmet::floating point arithmetic
transpar support arbitrary-precis::transparently supports arbitrary-precision
support arbitrary-precis arithmet::supports arbitrary-precision arithmetic
decim float point::decimal floating point
float point number::floating point numbers
point number python::point numbers python
number python support::numbers python supports
support a wide::supports a wide
varieti of string::variety of string
string oper string::string operations strings
string in python::strings in python
python are immut::python are immutable
substitut of charact::substitution of characters
languag might alter::languages might alter
alter a string::alter a string
string in place::string in place
string in python::string in python
python perform consider::python performance considerations
consider sometim push::considerations sometimes push
techniqu in program::techniques in programs
program that modifi::programs that modify
join charact array::joining character arrays
array into string::arrays into strings
aspect of python::aspects of python
concept of collect::concept of collection
type in gener::types in general
gener a collect::general a collection
referenc or index::referenced or indexed
two basic form::two basic forms
sequenc and map::sequences and mappings
map the order::mappings the ordered
order sequenti type::ordered sequential types
type are list::types are lists
string all sequenc::strings all sequences
sequenc are index::sequences are indexed
type of object::type of object
includ multipl type::including multiple types
sequenc both string::sequence both strings
string and tupl::strings and tuples
tupl are immut::tuples are immutable
make them perfect::making them perfect
candid for dictionari::candidates for dictionary
mutabl ; element::mutable ; elements
sort in-plac map::sorted in-place mappings
unord type implement::unordered types implemented
form of dictionari::form of dictionaries
set of immut::set of immutable
defin a dictionari::define a dictionary
versa the key::versa the keys
immut python type::immutable python type
function thi make::function this makes
faster lookup time::faster lookup times
key not chang::keys not change
dictionari s lack::dictionary s lack
lack of order::lack of order
object and class::objects and classes
map between variabl::mappings between variable
refer are store::reference are stored
store as dictionari::stored as dictionaries
directli access metaprogram::directly accessible metaprogramming
straightforward and natur::straightforward and natural
process in python::process in python
python a set::python a set
set collect type::set collection type
type wa ad::type was added
languag in version::language in version
implementsset theoret oper::implementsset theoretic operations
type of set::types of sets
set and frozenset::set and frozenset
set is mutabl::set is mutable
mutabl and frozenset::mutable and frozenset
frozenset is immut::frozenset is immutable
hashabl and immut::hashable and immutable
extens collect manipul::extensive collection manipulating
collect manipul abil::collection manipulating abilities
built in contain::built in containment
gener iter protocol::generic iteration protocol
iter protocol python::iteration protocol python
python s greatest::python s greatest
greatest strengths,provid tool::greatest strengths,providing tools
strengths,provid tool suit::strengths,providing tools suited
includ " python::included " python
philosophi for internet-fac::philosophy for internet-facing
number of standard::number of standard
format and protocol::formats and protocols
asmim and http::asmime and http
modul for creat::modules for creating
creat graphic user::creating graphical user
graphic user interfac::graphical user interfaces
connect to relat::connecting to relational
pseudorandom number gener::pseudorandom number generators
arithmet with arbitrari::arithmetic with arbitrary
arbitrari precis decim::arbitrary precision decimals
manipul regular express::manipulating regular expressions
do unit test::doing unit testing
includ some part::included some parts
librari are cover::library are covered
cover by specif::covered by specifications
implement follow pep::implementation follows pep
librari is cross-platform::library is cross-platform
cross-platform python code::cross-platform python code
rewritten by altern::rewritten by alternative
implement the standard::implementations the standard
essenti to run::essential to run
python or emb::python or embed
python packag index::python package index
repositori of third-parti::repository of third-party
softwar for python::software for python
54,000 packag offer::54,000 packages offering
offer a wide::offering a wide
rang of function::range of functionality
network and commun::networking and communications
commun * test::communications * test
autom and web::automation and web
administr * scientif::administration * scientific
process most python::processing most python
command line interpret::command line interpreter
user enter statement::user enters statements
sequenti and receiv::sequentially and receives
receiv the result::receives the results
shell.oth shell add::shell.other shells add
shell add capabl::shells add capabilities
idl and ipython::idle and ipython
featur like auto-complet::features like auto-completion
retent of session::retention of session
syntax highlighting.in addit::syntax highlighting.in addition
addit to standard::addition to standard
standard desktop python::standard desktop python
desktop python ide::desktop python ides
integr develop environ::integrated development environments
intend for develop::intended for developing
scienc and math-rel::science and math-related
math-rel python program::math-related python programs
ide and host::ide and hosting
pythonanywher the main::pythonanywhere the main
main python implement::main python implementation
meet the c89::meeting the c89
standard it compil::standard it compiles
compil python program::compiles python programs
program into intermedi::programs into intermediate
virtual machin cpython::virtual machine cpython
cpython is distribut::cpython is distributed
standard librari written::standard library written
includ microsoft window::including microsoft windows
modern unix-lik system::modern unix-like systems
unix-lik system cpython::unix-like systems cpython
cpython wa intend::cpython was intended
interpret of python::interpreter of python
just-in-tim compil bring::just-in-time compiler brings
bring a signific::brings a significant
signific speed improv::significant speed improvement
improv over cpython::improvement over cpython
cpython a version::cpython a version
version take advantag::version taking advantage
advantag of multi-cor::advantage of multi-core
processor use softwar::processors using software
softwar transact memori::software transactional memory
creat stackless python::created stackless python
fork of cpython::fork of cpython
cpython that implement::cpython that implements
allow massiv concurr::allowing massively concurrent
massiv concurr program::massively concurrent programs
concurr program pypi::concurrent programs pypy
start a project::started a project
project call unladen::project called unladen
aim of increas::aims of increasing
increas the speed::increasing the speed
llvm and improv::llvm and improving
improv it multithread::improving its multithreading
abil to scale::ability to scale
scale to thousand::scale to thousands
thousand of core::thousands of cores
project lost googl::project lost google
googl s back::google s backing
faster than cpython::faster than cpython
cpython * psyco::cpython * psyco
compil that integr::compiler that integrates
integr with cpython::integrates with cpython
cpython and transform::cpython and transforms
bytecod to machin::bytecode to machine
code at runtim::code at runtime
runtim the produc::runtime the produced
code is specialis::code is specialised
faster than standard::faster than standard
standard python code::standard python code
releas a python::released a python
phone call pys60::phones called pys60
pys60 it includ::pys60 it includes
modul for integr::modules for integration
symbian oper system::symbian operating system
system thi project::system this project
date to run::date to run
n900 also support::n900 also supports
python with gtk::python with gtk
gtk widget librari::gtk widget libraries
featur that program::feature that programs
written and run::written and run
compil to high-level::compilers to high-level
high-level object languag::high-level object languages
subset of python::subset of python
similar to python::similar to python
compil into java::compiles into java
java byte code::java byte code
java virtual machin::java virtual machine
virtual machin implement::virtual machine implementation
java class librari::java class library
class librari function::class library functions
python program ironpython::python program ironpython
approach in order::approach in order
order to run::order to run
run python program::run python programs
.net common languag::.net common language
common languag runtim::common language runtime
runtim the rpython::runtime the rpython
common intermedi languag::common intermediate language
build the pypi::build the pypy
python pyjama compil::python pyjamas compiles
pyjama compil python::pyjamas compiles python
python to javascript.cython::python to javascript.cython
javascript.cython and pyrex::javascript.cython and pyrex
workload wa present::workload was presented
present at euroscipi::presented at euroscipy
euroscipi 13 python::euroscipy 13 python
python s develop::python s development
develop is conduct::development is conducted
python enhanc propos::python enhancement proposal
process the pep::process the pep
mechan for propos::mechanism for proposing
major new featur::major new features
collect commun input::collecting community input
document the design::documenting the design
python outstand pep::python outstanding peps
pep are review::peps are reviewed
review and comment::reviewed and commented
project s bdfl::project s bdfl
cpython refer implement::cpython reference implementation
implement the mail::implementation the mailing
mail list python-dev::mailing list python-dev
forum for discuss::forum for discussion
languag s develop::language s development
develop ; specif::development ; specific
issu are discuss::issues are discussed
roundup bug tracker::roundup bug tracker
bug tracker maintain::bug tracker maintained
maintain at python.org::maintained at python.org
python.org develop take::python.org development takes
develop take place::development takes place
self-host sourc code::self-hosted source code
sourc code repositori::source code repository
code repositori run::code repository running
repositori run mercuri::repository running mercurial
run mercuri cpython::running mercurial cpython
cpython s public::cpython s public
number is increment::number is incremented
code is expect::code is expected
expect to break::expected to break
port the first::ported the first
increment these releas::incremented these releases
featur " releas::feature " releases
compat but introduc::compatible but introduce
introduc new featur::introduce new features
releas are schedul::releases are scheduled
schedul to occur::scheduled to occur
version is support::version is supported
support by bugfix::supported by bugfixes
releas * bugfix::release * bugfix
releas are made::releases are made
number of bug::number of bugs
month secur vulner::months security vulnerabilities
patch in bugfix::patched in bugfix
releas a number::releases a number
number of alpha::number of alpha
releas as preview::released as previews
releas is made::release is made
readi the develop::ready the development
develop team monitor::development team monitor
monitor the state::monitor the state
code by run::code by running
run the larg::running the large
larg unit testsuit::large unit testsuite
testsuit dure develop::testsuite during development
buildbot continu integr::buildbot continuous integration
continu integr system::continuous integration system
system the commun::system the community
commun of python::community of python
58,000 softwar modul::58,000 software modules
librari for python::libraries for python
python the major::python the major
major academ confer::major academic conference
confer on python::conference on python
python is name::python is named
special mentor programm::special mentoring programmes
pyladi the except::pyladies the exception
class are defin::classes are defined
standard librari document::standard library documentation
document in addit::documentation in addition
obviou organiz benefit::obvious organizational benefits
caught by catch::caught by catching
catch their base::catching their base
rais directli baseexcept::raised directly baseexception
directli baseexcept base::directly baseexception base
baseexcept base class::baseexception base class
except implement logic::exceptions implements logic
logic for creat::logic for creating
creat a string::creating a string
except use str::exception using str
constructor except base::constructor exception base
except base class::exception base class
class for except::class for exceptions
result in quit::result in quitting
quit the run::quitting the running
applic all user-defin::application all user-defined
base class standarderror::base class standarderror
class standarderror base::class standarderror base
standarderror base class::standarderror base class
class for built-in::class for built-in
standard librari arithmeticerror::standard library arithmeticerror
librari arithmeticerror base::library arithmeticerror base
arithmeticerror base class::arithmeticerror base class
class for math-rel::class for math-related
math-rel error lookuperror::math-related errors lookuperror
error lookuperror base::errors lookuperror base
lookuperror base class::lookuperror base class
class for error::class for errors
found environmenterror base::found environmenterror base
environmenterror base class::environmenterror base class
assertionerror an assertionerror::assertionerror an assertionerror
assertionerror is rais::assertionerror is raised
fail assert statement::failed assert statement
statement the simplest::statement the simplest
try-except " block::try-except " block
catch all error::catch all errors
possibl be gener::possibly be generated
catch-al except claus::catch-all exception clause
user press ctrl-c::user presses ctrl-c
gener a keyboard::generating a keyboard
program to print::program to print
print " divid::print " divide
write an extens::writing an extension
inform to output::information to output
output the output::output the output
output web page::output web page
server to continu::server to continue
continu to run::continue to run
idea what kind::idea what kind
kind of error::kind of errors
code moinmoin softwar::code moinmoin software
gener error catch::general error catching
catch is good::catching is good
write moinmoin extens::write moinmoin extension
moinmoin extens macro::moinmoin extension macros
trigger an error::trigger an error
moinmoin will give::moinmoin will give
chain of event::chain of events
design philosophi::design philosophy
philosophi emphas::philosophy emphasizes
emphas code::emphasizes code
code readabl::code readability
express concept::express concepts
fewer line::fewer lines
construct intend::constructs intended
enabl clear::enable clear
clear program::clear programs
larg scale::large scale
scale python::scale python
python support::python supports
support multipl::supports multiple
program paradigm::programming paradigms
function program::functional programming
procedur style::procedural styles
dynam type::dynamic type
type system::type system
automat memori::automatic memory
memori manag::memory management
comprehens standard::comprehensive standard
standard librari::standard library
librari python::library python
python interpret::python interpreters
oper system::operating systems
allow python::allowing python
python code::python code
code execut::code execution
wide varieti::wide variety
third-parti tool::third-party tools
stand-alon execut::stand-alone executable
execut program::executable programs
popular oper::popular operating
python-bas softwar::python-based software
python interpret::python interpreter
interpret cpython::interpreter cpython
refer implement::reference implementation
open-sourc softwar::open-source software
community-bas develop::community-based development
develop model::development model
altern implement::alternative implementations
implement cpython::implementations cpython
non-profit python::non-profit python
python softwar::python software
softwar foundat::software foundation
foundat python::foundation python
multi-paradigm program::multi-paradigm programming
program languag::programming language
object-ori program::object-oriented programming
structur program::structured programming
languag featur::language features
aspect-ori program::aspect-oriented programming
magic method::magic methods
includ design::including design
logic program::logic programming
program python::programming python
dynam type::dynamic typing
refer count::reference counting
cycle-detect garbag::cycle-detecting garbage
garbag collector::garbage collector
import featur::important feature
late bind::late binding
bind method::binds method
variabl name::variable names
program execut::program execution
python offer::python offers
lisp tradit::lisp tradition
gener express::generator expressions
function tool::functional tools
tool borrow::tools borrowed
core philosophi::core philosophy
includ aphor::includes aphorisms
complicated.read count::complicated.readability counts
desir function::desired functionality
highli extens::highly extensible
extens python::extensible python
exist applic::existing applications
programm interfac::programmable interface
small core::small core
core languag::core language
larg standard::large standard
extens interpret::extensible interpreter
van rossum::van rossum
opposit mindset::opposite mindset
offer choic::offering choice
code methodolog::coding methodology
python philosophi::python philosophy
philosophi reject::philosophy rejects
reject exuber::rejects exuberant
exuber syntax::exuberant syntax
less-clutt grammar::less-cluttered grammar
alex put::alex put
python cultur::python culture
cultur python::culture python
languag design::language design
develop strive::developers strive
avoid prematur::avoid premature
prematur optim::premature optimization
reject patch::reject patches
non-crit part::non-critical parts
margin increas::marginal increase
python programm::python programmers
just-in-tim compil::just-in-time compiler
time-crit function::time-critical functions
extens modul::extension modules
modul written::modules written
python script::python script
level api::level api
api call::api calls
import goal::important goal
python develop::python developers
make python::making python
python fun::python fun
monti python::monty python
play approach::playful approach
refer materi::reference materials
standard foo::standard foo
common neolog::common neologism
python commun::python community
wide rang::wide range
mean relat::meanings related
program style::program style
python idiom::python idioms
show fluenci::shows fluency
minimalist philosophi::minimalist philosophy
rough transcript::rough transcription
python program::python programming
python program::python program
runtim system::runtime system
human reader::human readers
readabl language.it::readable language.it
english keyword::english keywords
punctuat python::punctuation python
python aim::python aims
delimit program::delimit program
program block::program blocks
off-sid rule::off-side rule
rule python::rule python
python borrow::python borrows
predecessor abc::predecessor abc
block structur::block structure
structur deriv::structure derived
code convent::coding conventions
surround code::surrounding code
python mandat::python mandates
algol-styl languag::algol-style languages
free-form syntax::free-form syntax
good indent::good indentation
indent code::indented code
human reader::human reader
type languag::typed language
python valu::python values
carri type::carry type
languag function::language functions
python hold::python hold
hold refer::hold references
variabl refer::variable references
call function::calling function
includ guido::including guido
guido van::guido van
parameter-pass scheme::parameter-passing scheme
object refer::object reference
refer mean::reference means
pass refer::passed reference
broad rang::broad range
basic data::basic data
data type::data types
type alongsid::types alongside
convent integ::conventional integer
float point::floating point
support arbitrary-precis::supports arbitrary-precision
complex number::complex numbers
decim float::decimal floating
point number::point numbers
number python::numbers python
string oper::string operations
oper string::operations strings
string oper::string operation
program languag::programming languages
python perform::python performance
perform consider::performance considerations
special techniqu::special techniques
modifi string::modify strings
join charact::joining character
charact array::character arrays
index collect::indexed collections
basic form::basic forms
sequenti type::sequential types
dynam array::dynamic arrays
includ multipl::including multiple
multipl type::multiple types
perfect candid::perfect candidates
dictionari key::dictionary keys
sort in-plac::sorted in-place
in-plac map::in-place mappings
unord type::unordered types
type implement::types implemented
immut key::immutable keys
mathemat function::mathematical function
string map::string mapped
vice versa::vice versa
immut python::immutable python
python type::python type
hash function::hash function
faster lookup::faster lookup
lookup time::lookup times
requir key::requires keys
python object::python objects
name refer::names reference
object system::object system
access metaprogram::accessible metaprogramming
natur process::natural process
set collect::set collection
collect type::collection type
unord collect::unordered collection
theoret oper::theoretic operations
symmetr differ::symmetric difference
subset test::subset testing
immut element::immutable elements
regular set::regular set
true python::true python
extens collect::extensive collection
collect manipul::collection manipulating
manipul abil::manipulating abilities
contain check::containment checking
gener iter::generic iteration
iter protocol::iteration protocol
protocol python::protocol python
greatest strengths,provid::greatest strengths,providing
strengths,provid tool::strengths,providing tools
tool suit::tools suited
batteri includ::batteries included
internet-fac applic::internet-facing applications
larg number::large number
standard format::standard formats
support modul::supported modules
graphic user::graphical user
user interfac::user interfaces
relat databas::relational databases
pseudorandom number::pseudorandom number
number gener::number generators
arbitrari precis::arbitrary precision
precis decim::precision decimals
regular express::regular expressions
do unit::doing unit
unit test::unit testing
wsgi implement::wsgi implementation
intern document::internal documentation
test suit::test suite
cross-platform python::cross-platform python
run python::run python
emb python::embed python
applic blender::application blender
python packag::python package
packag index::package index
offici repositori::official repository
third-parti softwar::third-party software
packag offer::packages offering
web framework::web frameworks
test framework::test frameworks
web scrape::web scraping
document tool::documentation tools
system administr::system administration
scientif comput::scientific computing
text process::text processing
imag process::image processing
python implement::python implementations
includ cpython::including cpython
command line::command line
line interpret::line interpreter
user enter::user enters
enter statement::enters statements
python act::python acts
shell.oth shell::shell.other shells
shell add::shells add
add capabl::add capabilities
basic interpret::basic interpreter
includ idl::including idle
visual style::visual style
python shell::python shell
implement featur::implement features
session state::session state
syntax highlighting.in::syntax highlighting.in
highlighting.in addit::highlighting.in addition
desktop python::desktop python
python ide::python ides
integr develop::integrated development
develop environ::development environments
browser-bas ide::browser-based ides
develop scienc::developing science
math-rel python::math-related python
python program::python programs
browser-bas ide::browser-based ide
host environ::hosting environment
main python::main python
python implement::python implementation
name cpython::named cpython
c89 standard::c89 standard
compil python::compiles python
intermedi bytecod::intermediate bytecode
virtual machin::virtual machine
machin cpython::machine cpython
librari written::library written
includ microsoft::including microsoft
microsoft window::microsoft windows
modern unix-lik::modern unix-like
unix-lik system::unix-like systems
system cpython::systems cpython
cross-platform pypi::cross-platform pypy
compliant interpret::compliant interpreter
compil bring::compiler brings
signific speed::significant speed
speed improv::speed improvement
version take::version taking
take advantag::taking advantage
multi-cor processor::multi-core processors
transact memori::transactional memory
creat stackless::created stackless
stackless python::stackless python
signific fork::significant fork
implement microthread::implements microthreads
memori stack::memory stack
concurr program::concurrent programs
program pypi::programs pypy
stackless version::stackless version
just-in-tim compil::just-in-time compilers
unladen swallow::unladen swallow
multithread abil::multithreading ability
project lost::project lost
main develop::main developers
modifi interpret::modified interpreter
transform bytecod::transforms bytecode
machin code::machine code
produc code::produced code
standard python::standard python
nokia releas::nokia released
mobil phone::mobile phones
cpython implement::cpython implementations
addit modul::additional modules
symbian oper::symbian operating
oper system::operating system
s60 platform::s60 platform
parti modul::party modules
nokia n900::nokia n900
support python::supports python
gtk widget::gtk widget
widget librari::widget libraries
high-level object::high-level object
object languag::object languages
unrestrict python::unrestricted python
restrict subset::restricted subset
sourc languag::source language
jython compil::jython compiles
java byte::java byte
byte code::byte code
machin implement::machine implementation
java class::java class
class librari::class library
librari function::library functions
program ironpython::program ironpython
similar approach::similar approach
.net common::.net common
common languag::common language
languag runtim::language runtime
rpython languag::rpython language
java bytecod::java bytecode
common intermedi::common intermediate
intermedi languag::intermediate language
pypi interpret::pypy interpreter
pyjama compil::pyjamas compiles
pyrex compil::pyrex compile
perform comparison::performance comparison
euroscipi 13::euroscipy 13
13 python::13 python
python enhanc::python enhancement
enhanc propos::enhancement proposal
pep process::pep process
primari mechan::primary mechanism
collect commun::collecting community
commun input::community input
design decis::design decisions
outstand pep::outstanding peps
python project::python project
bdfl enhanc::bdfl enhancement
cpython refer::cpython reference
mail list::mailing list
list python-dev::list python-dev
primari forum::primary forum
specif issu::specific issues
roundup bug::roundup bug
bug tracker::bug tracker
tracker maintain::tracker maintained
python.org develop::python.org development
develop take::development takes
take place::takes place
self-host sourc::self-hosted source
sourc code::source code
code repositori::code repository
repositori run::repository running
run mercuri::running mercurial
mercuri cpython::mercurial cpython
public releas::public releases
version number::version number
backwards-incompat version::backwards-incompatible versions
manual port::manually ported
first part::first part
releas happen::releases happen
major version::major version
bugfix releas::bugfix releases
final part::final part
suffici number::sufficient number
fix upstream::fixed upstream
last releas::last release
month secur::months security
secur vulner::security vulnerabilities
final releas::final release
rough schedul::rough schedule
develop team::development team
team monitor::team monitor
larg unit::large unit
unit testsuit::unit testsuite
continu integr::continuous integration
integr system::integration system
softwar modul::software modules
third-parti librari::third-party libraries
major academ::major academic
academ confer::academic conference
special mentor::special mentoring
mentor programm::mentoring programmes
except class::exception classes
librari document::library documentation
obviou organiz::obvious organizational
organiz benefit::organizational benefits
except inherit::exception inheritance
relat except::related exceptions
base class::base class
base class::base classes
baseexcept base::baseexception base
except implement::exceptions implements
implement logic::implements logic
string represent::string representation
argument pass::arguments passed
constructor except::constructor exception
except base::exception base
run applic::running application
user-defin except::user-defined exceptions
class standarderror::class standarderror
standarderror base::standarderror base
built-in except::built-in exceptions
librari arithmeticerror::library arithmeticerror
arithmeticerror base::arithmeticerror base
math-rel error::math-related errors
error lookuperror::errors lookuperror
lookuperror base::lookuperror base
error rais::errors raised
found environmenterror::found environmenterror
environmenterror base::environmenterror base
fail assert::failed assert
assert statement::assert statement
handl except::handle exceptions
catch-al except::catch-all exception
except claus::exception clause
user press::user presses
keyboard interrupt::keyboard interrupt
extens modul::extension module
web servic::web service
error inform::error information
output web::output web
web page::web page
code moinmoin::code moinmoin
moinmoin softwar::moinmoin software
gener error::general error
error catch::error catching
moinmoin extens::moinmoin extension
extens macro::extension macros
detail report::detailed report
event lead::events leading
python::python
wide::widely
general-purpos::general-purpose
languag::language
design::design
philosophi::philosophy
emphas::emphasizes
code::code
readabl::readability
syntax::syntax
programm::programmers
express::express
concept::concepts
fewer::fewer
line::lines
languag::languages
java::java
construct::constructs
intend::intended
enabl::enable
clear::clear
program::programs
small::small
larg::large
scale::scale
support::supports
multipl::multiple
program::programming
paradigm::paradigms
includ::including
object-ori::object-oriented
imper::imperative
function::functional
procedur::procedural
style::styles
featur::features
dynam::dynamic
type::type
system::system
automat::automatic
memori::memory
manag::management
comprehens::comprehensive
standard::standard
librari::library
interpret::interpreters
instal::installation
oper::operating
system::systems
allow::allowing
execut::execution
wide::wide
varieti::variety
third-parti::third-party
tool::tools
py2ex::py2exe
pyinstal::pyinstaller
packag::packaged
stand-alon::stand-alone
execut::executable
popular::popular
distribut::distribution
python-bas::python-based
softwar::software
environ::environments
requir::requiring
interpret::interpreter
cpython::cpython
refer::reference
implement::implementation
free::free
open-sourc::open-source
community-bas::community-based
develop::development
model::model
altern::alternative
implement::implementations
manag::managed
non-profit::non-profit
foundat::foundation
multi-paradigm::multi-paradigm
structur::structured
fulli::fully
support::supported
number::number
support::support
aspect-ori::aspect-oriented
metaprogram::metaprogramming
magic::magic
method::methods
extens::extensions
contract::contract
logic::logic
type::typing
combin::combination
count::counting
cycle-detect::cycle-detecting
garbag::garbage
collector::collector
import::important
featur::feature
resolut::resolution
late::late
bind::binding
bind::binds
method::method
variabl::variable
name::names
program::program
offer::offers
lisp::lisp
tradit::tradition
map::map
reduc::reduce
filter::filter
function::functions
comprehens::comprehensions
list::lists
dictionari::dictionaries
set::sets
gener::generator
express::expressions
two::two
modul::modules
itertool::itertools
functool::functools
implement::implement
borrow::borrowed
haskel::haskell
core::core
summar::summarized
document::document
pep::pep
zen::zen
includ::includes
aphor::aphorisms
beauti::beautiful
ugly.explicit::ugly.explicit
implicitsimpl::implicitsimple
complex.complex::complex.complex
complicated.read::complicated.readability
count::counts
desir::desired
function::functionality
built::built
design::designed
highli::highly
extens::extensible
embed::embedded
exist::existing
applic::applications
programm::programmable
interfac::interface
easili::easily
van::van
rossum::rossum
start::start
frustrat::frustrations
abc::abc
espous::espoused
opposit::opposite
mindset::mindset
offer::offering
choic::choice
code::coding
methodolog::methodology
reject::rejects
exuber::exuberant
perl::perl
favor::favor
sparser::sparser
less-clutt::less-cluttered
grammar::grammar
alex::alex
put::put
describ::describe
clever::clever
consid::considered
compliment::compliment
cultur::culture
approach::approach
prefer::preferably
obviou::obvious
develop::developers
strive::strive
avoid::avoid
prematur::premature
optim::optimization
reject::reject
patch::patches
non-crit::non-critical
part::parts
offer::offer
margin::marginal
increas::increase
speed::speed
cost::cost
clariti::clarity
pypi::pypy
just-in-tim::just-in-time
compil::compiler
move::move
time-crit::time-critical
extens::extension
written::written
cython::cython
translat::translates
script::script
make::makes
direct::direct
level::level
api::api
call::calls
goal::goal
make::making
fun::fun
reflect::reflected
origin::origin
monti::monty
occasion::occasionally
play::playful
tutori::tutorials
materi::materials
exampl::examples
spam::spam
egg::eggs
foo::foo
bar::bar
common::common
neolog::neologism
commun::community
python::pythonic
rang::range
mean::meanings
relat::related
style::style
idiom::idioms
natur::natural
show::shows
fluenci::fluency
conform::conforms
minimalist::minimalist
emphasi::emphasis
contrast::contrast
difficult::difficult
understand::understand
read::reads
rough::rough
transcript::transcription
unpython::unpythonic
user::users
admir::admirers
knowledg::knowledgeable
experienc::experienced
refer::referred
pythonist::pythonists
pythonista::pythonistas
python::pythoneers
set::set
rule::rules
defin::defines
interpret::interpreted
runtim::runtime
human::human
reader::readers
.python::.python
readabl::readable
language.it::language.it
unclutt::uncluttered
visual::visual
layout::layout
english::english
keyword::keywords
frequent::frequently
punctuat::punctuation
aim::aims
simplic::simplicity
gener::generality
encapsul::encapsulated
mantra::mantra
whitespac::whitespace
delimit::delimit
block::blocks
off-sid::off-side
rule::rule
borrow::borrows
predecessor::predecessor
indent::indentation
run::run
block::block
so-cal::so-called
free-format::free-format
structur::structure
deriv::derived
algol::algol
brace::braces
convent::conventions
convent::conventionally
indent::indent
visual::visually
surround::surrounding
prettyprint::prettyprinting
mandat::mandates
convent::convention
algol-styl::algol-style
follow::follow
free-form::free-form
good::good
enforc::enforced
incorrectli::incorrectly
indent::indented
understood::understood
reader::reader
differ::differently
dynam::dynamically
type::typed
valu::values
variabl::variables
carri::carry
implic::implications
aspect::aspects
hold::hold
refer::references
object::objects
pass::passed
function::function
chang::change
valu::value
call::calling
true::true
peopl::people
guido::guido
parameter-pass::parameter-passing
scheme::scheme
call::call
object::object
mean::means
alia::alias
i.e::i.e
copi::copy
chang::changed
broad::broad
basic::basic
data::data
type::types
alongsid::alongside
convent::conventional
integ::integer
float::floating
point::point
arithmet::arithmetic
transpar::transparently
arbitrary-precis::arbitrary-precision
complex::complex
number::numbers
decim::decimal
string::string
oper::operations
string::strings
immut::immutable
oper::operation
substitut::substitution
charact::characters
alter::alter
place::place
return::returns
perform::performance
consider::considerations
push::push
special::special
techniqu::techniques
modifi::modify
intens::intensively
join::joining
charact::character
array::arrays
need::needed
concept::concept
collect::collection
contain::container
gener::general
referenc::referenced
index::indexed
collect::collections
form::forms
sequenc::sequences
map::mappings
order::ordered
sequenti::sequential
tupl::tuples
posit::positionally
length::length
sequenc::sequence
perfect::perfect
candid::candidates
dictionari::dictionary
key::keys
hand::hand
mutabl::mutable
element::elements
insert::inserted
delet::deleted
modifi::modified
append::appended
sort::sorted
in-plac::in-place
unord::unordered
implement::implemented
form::form
mathemat::mathematical
defin::define
map::mapped
vice::vice
versa::versa
hood::hood
hash::hash
faster::faster
lookup::lookup
time::times
requir::requires
result::results
lack::lack
order::order
central::central
intern::internals
resid::reside
class::classes
store::stored
directli::directly
access::accessible
straightforward::straightforward
process::process
ad::added
version::version
unindex::unindexed
duplic::duplicates
implementsset::implementsset
theoret::theoretic
union::union
intersect::intersection
differ::difference
symmetr::symmetric
subset::subset
test::testing
frozenset::frozenset
hashabl::hashable
afrozenset::afrozenset
element::element
regular::regular
extens::extensive
manipul::manipulating
abil::abilities
contain::containment
check::checking
gener::generic
iter::iteration
protocol::protocol
commonli::commonly
cite::cited
greatest::greatest
strengths,provid::strengths,providing
suit::suited
task::tasks
deliber::deliberate
describ::described
batteri::batteries
includ::included
internet-fac::internet-facing
format::formats
protocol::protocols
asmim::asmime
http::http
creat::creating
graphic::graphical
user::user
interfac::interfaces
connect::connecting
relat::relational
databas::databases
pseudorandom::pseudorandom
gener::generators
arbitrari::arbitrary
precis::precision
decim::decimals
do::doing
unit::unit
cover::covered
specif::specifications
wsgi::wsgi
major::majority
intern::internal
document::documentation
test::test
suit::suite
suppli::supplied
cross-platform::cross-platform
alter::altered
complet::completely
rewritten::rewritten
essenti::essential
emb::embed
applic::application
blender::blender
instanc::instance
omit::omits
januari::january
packag::package
index::index
offici::official
repositori::repository
54,000::54,000
packag::packages
web::web
framework::frameworks
multimedia::multimedia
network::networking
commun::communications
autom::automation
scrape::scraping
administr::administration
scientif::scientific
comput::computing
text::text
process::processing
imag::image
command::command
line::line
enter::enters
statement::statements
sequenti::sequentially
receiv::receives
immedi::immediately
repl::repl
short::short
act::acts
shell.oth::shell.other
shell::shells
add::add
capabl::capabilities
idl::idle
ipython::ipython
gener::generally
shell::shell
auto-complet::auto-completion
retent::retention
session::session
state::state
highlighting.in::highlighting.in
addit::addition
desktop::desktop
ide::ides
integr::integrated
browser-bas::browser-based
sage::sage
develop::developing
scienc::science
math-rel::math-related
ide::ide
host::hosting
environ::environment
pythonanywher::pythonanywhere
main::main
name::named
meet::meeting
c89::c89
compil::compiles
intermedi::intermediate
bytecod::bytecode
execut::executed
virtual::virtual
machin::machine
distribut::distributed
mixtur::mixture
version::versions
platform::platforms
microsoft::microsoft
window::windows
modern::modern
unix-lik::unix-like
concept::conception
fast::fast
compliant::compliant
bring::brings
signific::significant
improv::improvement
take::taking
advantag::advantage
multi-cor::multi-core
processor::processors
transact::transactional
creat::created
stackless::stackless
fork::fork
implement::implements
microthread::microthreads
stack::stack
massiv::massively
concurr::concurrent
compil::compilers
develop::developed
past::past
unsupport::unsupported
googl::google
start::started
project::project
unladen::unladen
swallow::swallow
increas::increasing
llvm::llvm
improv::improving
multithread::multithreading
abil::ability
thousand::thousands
core::cores
lost::lost
back::backing
februari::february
psyco::psyco
specialis::specialising
integr::integrates
transform::transforms
produc::produced
specialis::specialised
nokia::nokia
releas::released
seri::series
mobil::mobile
phone::phones
pys60::pys60
addit::additional
integr::integration
symbian::symbian
date::date
variant::variants
s60::s60
platform::platform
parti::party
n900::n900
gtk::gtk
widget::widget
librari::libraries
devic::device
high-level::high-level
unrestrict::unrestricted
restrict::restricted
similar::similar
sourc::source
jython::jython
byte::byte
enabl::enables
class::class
ironpython::ironpython
.net::.net
rpython::rpython
compil::compiled
build::build
pyjama::pyjamas
javascript.cython::javascript.cython
pyrex::pyrex
compil::compile
comparison::comparison
non-numer::non-numerical
combinatori::combinatorial
workload::workload
present::presented
euroscipi::euroscipy
13::13
conduct::conducted
larg::largely
enhanc::enhancement
propos::proposal
primari::primary
mechan::mechanism
propos::proposing
major::major
collect::collecting
input::input
issu::issue
document::documenting
decis::decisions
outstand::outstanding
pep::peps
review::reviewed
comment::commented
bdfl::bdfl
mail::mailing
list::list
python-dev::python-dev
forum::forum
discuss::discussion
specif::specific
issu::issues
discuss::discussed
roundup::roundup
bug::bug
tracker::tracker
maintain::maintained
python.org::python.org
take::takes
self-host::self-hosted
run::running
mercuri::mercurial
public::public
releas::releases
distinguish::distinguished
part::part
increment::incremented
backwards-incompat::backwards-incompatible
expect::expected
break::break
manual::manually
port::ported
first::first
happen::happen
infrequ::infrequently
year::years
compat::compatible
introduc::introduce
schedul::scheduled
occur::occur
roughli::roughly
month::months
bugfix::bugfixes
releas::release
bugfix::bugfix
fix::fix
bug::bugs
final::final
made::made
suffici::sufficient
fix::fixed
upstream::upstream
last::last
secur::security
vulner::vulnerabilities
patch::patched
alpha::alpha
beta::beta
release-candid::release-candidates
preview::previews
schedul::schedule
push::pushed
back::back
readi::ready
team::team
monitor::monitor
testsuit::testsuite
buildbot::buildbot
continu::continuous
contribut::contributed
58,000::58,000
pypi::pypi
academ::academic
confer::conference
pycon::pycon
mentor::mentoring
programm::programmes
pyladi::pyladies
except::exception
defin::defined
hierarchi::hierarchy
organiz::organizational
benefit::benefits
inherit::inheritance
except::exceptions
caught::caught
catch::catching
base::base
case::cases
rais::raised
baseexcept::baseexception
represent::representation
str::str
argument::arguments
constructor::constructor
result::result
quit::quitting
user-defin::user-defined
standarderror::standarderror
built-in::built-in
arithmeticerror::arithmeticerror
error::errors
lookuperror::lookuperror
found::found
environmenterror::environmenterror
filesystem::filesystem
assertionerror::assertionerror
fail::failed
assert::assert
statement::statement
simplest::simplest
handl::handle
try-except::try-except
catch::catch
possibl::possibly
gener::generated
don::don
catch-al::catch-all
claus::clause
press::presses
ctrl-c::ctrl-c
gener::generating
keyboard::keyboard
interrupt::interrupt
nt::nt
print::print
divid::divide
situat::situations
suppos::suppose
write::writing
modul::module
servic::service
error::error
inform::information
output::output
page::page
server::server
continu::continue
idea::idea
kind::kind
moinmoin::moinmoin
write::write
macro::macros
trigger::trigger
give::give
detail::detailed
report::report
chain::chain
event::events
lead::leading
deliv::deliver
recipi::recipient
