::
represent::representation
all::all
code::code
multi-paradigm::multi-paradigm
chain::chain
lack::lack
monti::monty
month::months
although::although
signific::significant
concept::conception
abil::ability
follow::follows
auto-complet::auto-completion
user-defin::user-defined
consider::considerations
cython::cython
decim::decimals
readabl::readable
unpython::unpythonic
to::to
program::program
present::presented
unladen::unladen
under::under
introduc::introduce
sourc::source
everi::every
string::string
straightforward::straightforward
complicated.read::complicated.readability
mechan::mechanism
shell.oth::shell.other
upstream::upstream
veri::very
n900::n900
magic::magic
administr::administration
level::level
lisp::lisp
list::list
fewer::fewer
arithmeticerror::arithmeticerror
concurr::concurrent
alia::alias
small::small
general-purpos::general-purpose
be::be
natur::natural
built-in::built-in
direct::direct
maintain::maintained
past::past
second::second
cost::cost
design::design
pass::passed
port::ported
append::appended
compat::compatible
will::will
what::what
abc::abc
entir::entirely
+::+
multimedia::multimedia
abl::able
access::accessible
delet::deleted
version::version
intersect::intersection
conduct::conducted
new::new
;::;
method::method
contrast::contrast
widget::widget
hash::hash
deriv::derived
internet-fac::internet-facing
gener::general
error::errors
asmim::asmime
i.e::i.e
along::along
modifi::modified
sinc::since
interpret::interpreter
mindset::mindset
39::39
produc::produced
forum::forum
host::hosting
precis::precision
58,000::58,000
implement::implements
commonli::commonly
via::via
pythonanywher::pythonanywhere
intermedi::intermediate
modul::module
prefer::preferably
333::333
expect::expected
releas::release
api::api
instal::installation
mobil::mobile
unit::unit
highli::highly
use::using
from::from
describ::described
would::would
commun::community
baseexcept::baseexception
implicitsimpl::implicitsimple
two::two
perl::perl
implic::implications
few::few
call::called
preview::previews
type::types
start::started
more::more
sort::sorted
community-bas::community-based
desir::desired
comparison::comparison
peopl::people
relat::related
enhanc::enhancement
phone::phones
visual::visual
hold::hold
must::must
graphic::graphical
join::joining
pythonista::pythonistas
ml::ml
testsuit::testsuite
imper::imperative
neolog::neologism
can::can
meet::meeting
object-ori::object-oriented
encapsul::encapsulated
give::give
process::process
indic::indicate
n't::n't
want::want
occur::occur
contribut::contributed
complex.complex::complex.complex
multipl::multiple
goal::goal
secur::security
rather::rather
anoth::another
1::1
how::how
reject::reject
instead::instead
scienc::science
map::mappings
referenc::referenced
may::may
after::after
variant::variants
reflect::reflected
befor::before
beauti::beautiful
date::date
such::such
philosophi::philosophy
data::data
a::a
short::short
essenti::essential
third::third
bind::binds
divid::divide
correspond::corresponding
so::so
issu::issues
receiv::receives
candid::candidates
combin::combination
s60::s60
allow::allowing
enter::enters
egg::eggs
order::order
oper::operating
self-host::self-hosted
sometim::sometimes
move::move
zen::zen
becaus::because
pseudorandom::pseudorandom
report::report
through::through
keyboard::keyboard
hierarchi::hierarchy
dynam::dynamic
perfect::perfect
write::write
style::style
aphor::aphorisms
20::20
directli::directly
fix::fixed
gtk::gtk
bytecod::bytecode
late::late
platform::platform
window::windows
comprehens::comprehensions
mail::mailing
main::main
might::might
alter::altered
2012::2012
then::then
them::them
good::good
return::returns
standarderror::standarderror
3::3
python::python
nokia::nokia
break::break
framework::frameworks
they::they
not::not
strengths,provid::strengths,providing
now::now
discuss::discussed
strive::strive
minimalist::minimalist
workload::workload
grammar::grammar
name::named
.net::.net
language.it::language.it
easili::easily
februari::february
each::each
fulli::fully
complet::completely
mean::means
compil::compile
transform::transforms
continu::continue
procedur::procedural
combinatori::combinatorial
open-sourc::open-source
iter::iteration
year::years
happen::happen
beyond::beyond
collector::collector
event::events
special::special
variabl::variable
network::networking
goe::goes
monitor::monitor
release-candid::release-candidates
unsupport::unsupported
rel::relatively
reader::reader
print::print
integr::integration
found::found
upon::upon
manipul::manipulating
situat::situations
free::free
standard::standard
symbian::symbian
base::base
dictionari::dictionaries
put::put
byte::byte
indent::indented
prettyprint::prettyprinting
could::could
omit::omits
exuber::exuberant
filter::filter
unindex::unindexed
length::length
enforc::enforced
place::place
outsid::outside
distinguish::distinguished
organiz::organizational
frequent::frequently
first::first
origin::origin
softwar::software
rang::range
*::*
obviou::obvious
pyrex::pyrex
carri::carry
clariti::clarity
number::number
one::one
restrict::restricted
arbitrary-precis::arbitrary-precision
fast::fast
array::arrays
massiv::massively
primari::primary
hood::hood
differ::difference
"::"
rewritten::rewritten
convent::conventional
script::script
caught::caught
unrestrict::unrestricted
system::system
construct::constructs
stack::stack
mercuri::mercurial
their::their
2::2
statement::statement
arithmet::arithmetic
scheme::scheme
less-clutt::less-cluttered
cite::cited
store::stored
python-bas::python-based
shell::shell
especi::especially
tool::tools
copi::copy
specifi::specified
arbitrari::arbitrary
part::part
review::reviewed
kept::kept
than::than
highlighting.in::highlighting.in
wide::wide
kind::kind
keyword::keywords
instanc::instance
provid::provides
18::18
non-crit::non-critical
off-sid::off-side
zero::zero
structur::structure
charact::character
project::project
str::str
were::were
posit::positionally
ugly.explicit::ugly.explicit
algol::algol
toward::towards
result::result
and::and
fork::fork
comput::computing
modern::modern
ani::any
try-except::try-except
packag::package
say::say
have::have
deliv::deliver
need::needs
element::element
built::built
inform::information
moreov::moreover
that::that
also::also
without::without
decis::decisions
take::takes
which::which
ctrl-c::ctrl-c
environ::environment
brace::braces
methodolog::methodology
espous::espoused
play::playful
distribut::distributed
index::index
54,000::54,000
object::object
mixtur::mixture
most::most
beta::beta
regular::regular
alpha::alpha
transcript::transcription
the::the
prematur::premature
tradit::tradition
simplic::simplicity
academ::academic
don::don
filesystem::filesystem
clear::clear
later::later
cover::covered
pyinstal::pyinstaller
doe::does
runtim::runtime
occasion::occasionally
usual::usually
microsoft::microsoft
recipi::recipient
wsgi::wsgi
show::shows
opposit::opposite
so-cal::so-called
sage::sage
syntax::syntax
bring::brings
session::session
buildbot::buildbot
rough::rough
high-level::high-level
blender::blender
onli::only
layout::layout
just::just
true::true
transact::transactional
moinmoin::moinmoin
state::state
cross-platform::cross-platform
should::should
public::public
suppos::suppose
c89::c89
8::8
offici::official
predecessor::predecessor
do::do
over::over
afrozenset::afrozenset
nearli::nearly
variou::various
express::expressions
pypi::pypi
autom::automation
repl::repl
increas::increasing
symmetr::symmetric
requir::requires
parameter-pass::parameter-passing
bar::bar
enabl::enables
emb::embed
whenev::whenever
borrow::borrows
patch::patched
common::common
contain::contains
where::where
unix-lik::unix-like
conform::conforms
bdfl::bdfl
set::set
aspect::aspects
float::floating
knowledg::knowledgeable
mutabl::mutable
mantra::mantra
see::see
are::are
fail::failed
2.0::2.0
2.7::2.7
best::best
2.4::2.4
just-in-tim::just-in-time
lost::lost
databas::databases
someth::something
favor::favor
written::written
outstand::outstanding
between::between
import::important
approach::approach
compliment::compliment
altern::alternative
wa::was
web::web
team::team
itertool::itertools
extens::extension
pythonist::pythonists
key::keys
frozenset::frozenset
functool::functools
come::come
addit::addition
both::both
c::c
last::last
delimit::delimit
hashabl::hashable
2.49::2.49
howev::however
contract::contract
constructor::constructor
etc::etc
tutori::tutorials
admir::admirers
logic::logic
mani::many
swallow::swallow
seri::series
comment::commented
point::point
schedul::schedule
format::formats
mentor::mentoring
60::60
ipython::ipython
suppli::supplied
batteri::batteries
summar::summarized
pycon::pycon
ad::added
better::better
java::java
union::union
devic::device
three::three
been::been
c/c::c/c
much::much
valu::values
basic::basic
immedi::immediately
emphas::emphasizes
imag::image
resolut::resolution
metaprogram::metaprogramming
3.0::3.0
argument::arguments
deliber::deliberate
2015::2015
understand::understand
unclutt::uncluttered
rpython::rpython
catch::catch
ironpython::ironpython
those::those
case::cases
these::these
python.org::python.org
servic::service
aim::aims
defin::defined
while::while
abov::above
guido::guido
fun::fun
margin::marginal
retent::retention
increment::incremented
advantag::advantage
almost::almost
is::is
it::it
lookuperror::lookuperror
itself::itself
in::in
t::t
sever::several
if::if
develop::developers
incorrectli::incorrectly
perform::performance
parti::party
make::makes
transpar::transparently
0::0
same::same
handl::handle
non-numer::non-numerical
complex::complex
2005::2005
document::documentation
difficult::difficult
http::http
optim::optimization
wherea::whereas
hand::hand
capabl::capabilities
rais::raised
user::user
improv::improving
third-parti::third-party
specialis::specialised
chang::change
techniqu::techniques
task::tasks
off::off
free-form::free-form
macro::macros
thu::thus
well::well
inherit::inheritance
exampl::example
command::command
greatest::greatest
thi::this
english::english
programm::programmes
model::model
paradigm::paradigms
roughli::roughly
propos::proposing
protocol::protocols
execut::executed
42::42
text::text
detail::detailed
math-rel::math-related
psyco::psyco
virtual::virtual
human::human
speed::speed
languag::language
mandat::mandates
except::exception
theoret::theoretic
desktop::desktop
add::add
versa::versa
catch-al::catch-all
5::5
vulner::vulnerabilities
build::build
applic::application
jython::jython
choic::choice
read::reads
foundat::foundation
browser-bas::browser-based
assert::assert
punctuat::punctuation
environmenterror::environmenterror
press::presses
alex::alex
apart::apart
insert::inserted
resid::reside
like::like
specif::specific
rossum::rossum
interrupt::interrupt
whitespac::whitespace
manual::manually
integ::integer
server::server
collect::collecting
benefit::benefits
unord::unordered
either::either
popular::popular
output::output
manag::management
often::often
some::some
back::back
understood::understood
intern::internal
3.2::3.2
backwards-incompat::backwards-incompatible
cycle-detect::cycle-detecting
intend::intended
pyladi::pyladies
librari::library
assertionerror::assertionerror
scale::scale
for::for
broad::broad
avoid::avoid
pep::peps
substitut::substitution
mathemat::mathematical
larg::large
microthread::microthreads
non-profit::non-profit
foo::foo
refer::reference
machin::machine
core::cores
stackless::stackless
run::run
multi-cor::multi-core
javascript.cython::javascript.cython
quit::quitting
pyjama::pyjamas
garbag::garbage
confer::conference
duplic::duplicates
repositori::repository
januari::january
immut::immutable
major::major
by::by
roundup::roundup
on::on
about::about
simplest::simplest
central::central
76::76
of::of
materi::materials
memori::memory
surround::surrounding
page::page
idl::idle
.python::.python
in-plac::in-place
act::acts
ide::ide
or::or
block::block
subset::subset
emphasi::emphasis
final::final
into::into
within::within
algol-styl::algol-style
automat::automatic
claus::clause
your::your
processor::processors
van::van
sparser::sparser
suffici::sufficient
spam::spam
frustrat::frustrations
support::supported
there::there
aspect-ori::aspect-oriented
haskel::haskell
class::class
avail::available
time-crit::time-critical
compliant::compliant
trigger::trigger
interfac::interfaces
includ::includes
way::way
suit::suite
implementsset::implementsset
function::functions
himself::himself
tracker::tracker
form::form
offer::offering
tupl::tuples
but::but
idea::idea
hi::his
translat::translates
line::line
ha::has
with::with
bug::bugs
count::counts
made::made
input::input
possibl::possible
bugfix::bugfix
scientif::scientific
up::up
lead::leading
below::below
free-format::free-format
embed::embedded
similar::similar
connect::connecting
gone::gone
featur::features
alongsid::alongside
creat::creating
certain::certain
dure::during
fluenci::fluency
an::an
as::as
clever::clever
exist::existing
at::at
cultur::culture
check::checking
python-dev::python-dev
readi::ready
googl::google
no::no
sequenti::sequentially
when::when
43::43
scrape::scraping
idiom::idioms
other::other
lookup::lookup
varieti::variety
test::testing
you::you
'13::'13
thousand::thousands
llvm::llvm
's::'s
py2ex::py2exe
sequenc::sequence
stand-alon::stand-alone
intens::intensively
cpython::cpython
consid::considered
reduc::reduce
multithread::multithreading
experienc::experienced
infrequ::infrequently
faster::faster
euroscipi::euroscipy
vice::vice
rule::rule
ignor::ignored
time::time
push::pushed
2009::2009
pys60::pys60
