good article click::good article click
free encyclopedia python::free encyclopedia python
encyclopedia python python::encyclopedia python python
python python logo::python python logo
logo and wordmark.svg::logo and wordmark.svg
wordmark.svg paradigm multi-paradigm::wordmark.svg paradigm multi-paradigm
designed by guido::designed by guido
guido van rossum::guido van rossum
van rossum developer::van rossum developer
rossum developer python::rossum developer python
developer python software::developer python software
python software foundation::python software foundation
foundation first appeared::foundation first appeared
years ago stable::years ago stable
ago stable release::ago stable release
typing discipline duck::typing discipline duck
cross-platform license python::cross-platform license python
license python software::license python software
software foundation license::software foundation license
foundation license filename::foundation license filename
license filename extensions::license filename extensions
filename extensions .py::filename extensions .py
website www.python.org major::website www.python.org major
www.python.org major implementations::www.python.org major implementations
major implementations cpython::major implementations cpython
pypy dialects cython::pypy dialects cython
stackless python influenced::stackless python influenced
influenced by abc::influenced by abc
programming at wikibooks::programming at wikibooks
widely used general-purpose::widely used general-purpose
high-level programming language::high-level programming language
design philosophy emphasizes::design philosophy emphasizes
philosophy emphasizes code::philosophy emphasizes code
emphasizes code readability::emphasizes code readability
syntax allows programmers::syntax allows programmers
programmers to express::programmers to express
concepts in fewer::concepts in fewer
lines of code::lines of code
language provides constructs::language provides constructs
intended to enable::intended to enable
enable clear programs::enable clear programs
small and large::small and large
python supports multiple::python supports multiple
supports multiple programming::supports multiple programming
multiple programming paradigms::multiple programming paradigms
imperative and functional::imperative and functional
programming or procedural::programming or procedural
styles it features::styles it features
features a dynamic::features a dynamic
dynamic type system::dynamic type system
system and automatic::system and automatic
automatic memory management::automatic memory management
large and comprehensive::large and comprehensive
comprehensive standard library::comprehensive standard library
allowing python code::allowing python code
python code execution::python code execution
variety of systems::variety of systems
systems using third-party::systems using third-party
py2exe or pyinstaller::py2exe or pyinstaller
packaged into stand-alone::packaged into stand-alone
stand-alone executable programs::stand-alone executable programs
popular operating systems::popular operating systems
distribution of python-based::distribution of python-based
environments without requiring::environments without requiring
requiring the installation::requiring the installation
python interpreter cpython::python interpreter cpython
implementation of python::implementation of python
free and open-source::free and open-source
community-based development model::community-based development model
alternative implementations cpython::alternative implementations cpython
cpython is managed::cpython is managed
non-profit python software::non-profit python software
software foundation contents::software foundation contents
features and philosophy::features and philosophy
syntax and semantics::syntax and semantics
statements and control::statements and control
influenced by python::influenced by python
external links history::external links history
creator of python::creator of python
python main article::python main article
history of python::history of python
python was conceived::python was conceived
implementation was started::implementation was started
started in december::started in december
rossum at cwi::rossum at cwi
inspired by setl::inspired by setl
capable of exception::capable of exception
handling and interfacing::handling and interfacing
amoeba operating system::amoeba operating system
rossum is python::rossum is python
python s principal::python s principal
continuing central role::continuing central role
role in deciding::role in deciding
deciding the direction::deciding the direction
direction of python::direction of python
python is reflected::python is reflected
dictator for life::dictator for life
origin of python::origin of python
van rossum wrote::van rossum wrote
hobby " programming::hobby " programming
week around christmas::week around christmas
christmas my office::christmas my office
hands i decided::hands i decided
decided to write::decided to write
write an interpreter::write an interpreter
descendant of abc::descendant of abc
hackers i chose::hackers i chose
slightly irreverent mood::slightly irreverent mood
fan of monty::fan of monty
python s flying::python s flying
included many major::included many major
major new features::major new features
including a full::including a full
full garbage collector::full garbage collector
collector and support::collector and support
support for unicode::support for unicode
release the development::release the development
process was changed::process was changed
transparent and community-backed::transparent and community-backed
period of testing::period of testing
multi-paradigm programming language::multi-paradigm programming language
programming and structured::programming and structured
number of language::number of language
features which support::features which support
support functional programming::support functional programming
programming and aspect-oriented::programming and aspect-oriented
including by metaprogramming::including by metaprogramming
paradigms are supported::paradigms are supported
supported using extensions::supported using extensions
design by contract::design by contract
python uses dynamic::python uses dynamic
combination of reference::combination of reference
cycle-detecting garbage collector::cycle-detecting garbage collector
collector for memory::collector for memory
management an important::management an important
feature of python::feature of python
python is dynamic::python is dynamic
dynamic name resolution::dynamic name resolution
method and variable::method and variable
names during program::names during program
execution the design::execution the design
design of python::design of python
offers some support::offers some support
support for functional::support for functional
tradition the language::tradition the language
language has map::language has map
functions ; comprehensions::functions ; comprehensions
comprehensions for lists::comprehensions for lists
itertools and functools::itertools and functools
implement functional tools::implement functional tools
functional tools borrowed::functional tools borrowed
borrowed from haskell::borrowed from haskell
haskell and standard::haskell and standard
language is summarized::language is summarized
document " pep::document " pep
zen of python::zen of python
complicated readability counts::complicated readability counts
requiring all desired::requiring all desired
language s core::language s core
python was designed::python was designed
highly extensible python::highly extensible python
embedded in existing::embedded in existing
interface this design::interface this design
small core language::small core language
large standard library::large standard library
easily extensible interpreter::easily extensible interpreter
interpreter was intended::interpreter was intended
intended by van::intended by van
frustrations with abc::frustrations with abc
espoused the opposite::espoused the opposite
choice in coding::choice in coding
python philosophy rejects::python philosophy rejects
philosophy rejects exuberant::philosophy rejects exuberant
rejects exuberant syntax::rejects exuberant syntax
grammar as alex::grammar as alex
alex martelli put::alex martelli put
considered a compliment::considered a compliment
python s philosophy::python s philosophy
rejects the perl::rejects the perl
approach to language::approach to language
design in favor::design in favor
python s developers::python s developers
strive to avoid::strive to avoid
avoid premature optimization::avoid premature optimization
patches to non-critical::patches to non-critical
parts of cpython::parts of cpython
offer a marginal::offer a marginal
increase in speed::increase in speed
cost of clarity::cost of clarity
speed is important::speed is important
programmers use pypy::programmers use pypy
move time-critical functions::move time-critical functions
functions to extension::functions to extension
extension modules written::extension modules written
written in languages::written in languages
translates a python::translates a python
direct c level::direct c level
level api calls::level api calls
interpreter an important::interpreter an important
developers is making::developers is making
making python fun::making python fun
occasionally playful approach::occasionally playful approach
approach to tutorials::approach to tutorials
tutorials and reference::tutorials and reference
spam and eggs::spam and eggs
foo and bar::foo and bar
community is pythonic::community is pythonic
range of meanings::range of meanings
related to program::related to program
code is pythonic::code is pythonic
natural or shows::natural or shows
conforms with python::conforms with python
python s minimalist::python s minimalist
philosophy and emphasis::philosophy and emphasis
emphasis on readability::emphasis on readability
readability in contrast::readability in contrast
difficult to understand::difficult to understand
understand or reads::understand or reads
users and admirers::users and admirers
admirers of python::admirers of python
knowledgeable or experienced::knowledgeable or experienced
python is intended::python is intended
highly readable language::highly readable language
frequently using english::frequently using english
languages use punctuation::languages use punctuation
number of syntactic::number of syntactic
exceptions and special::exceptions and special
semantics § indentation::semantics § indentation
python uses whitespace::python uses whitespace
braces or keywords::braces or keywords
termed the off-side::termed the off-side
rule an increase::rule an increase
increase in indentation::increase in indentation
decrease in indentation::decrease in indentation
signifies the end::signifies the end
python s statements::python s statements
executes a block::executes a block
block of code::block of code
contraction of else-if::contraction of else-if
capturing each element::capturing each element
condition is true::condition is true
attached code block::attached code block
caught and handled::caught and handled
ensures that clean-up::ensures that clean-up
exits the class::exits the class
code and attaches::code and attaches
attaches its local::attaches its local
programming the def::programming the def
defines a function::defines a function
function or method::function or method
encloses a code::encloses a code
acquiring a lock::acquiring a lock
code is run::code is run
run and releasing::run and releasing
releasing the lock::releasing the lock
opening a file::opening a file
allowing raii-like behavior::allowing raii-like behavior
behavior the pass::behavior the pass
needed to create::needed to create
create an empty::create an empty
empty code block::empty code block
block the assert::block the assert
debugging to check::debugging to check
check for conditions::check for conditions
apply the yield::apply the yield
returns a value::returns a value
function from python::function from python
operator this form::operator this form
coroutines the import::coroutines the import
modules whose functions::modules whose functions
functions or variables::functions or variables
program the print::program the print
statement was changed::statement was changed
function in python::function in python
support tail-call optimization::support tail-call optimization
optimization or first-class::optimization or first-class
support for coroutine-like::support for coroutine-like
functionality is provided::functionality is provided
python s generators::python s generators
generators were lazy::generators were lazy
iterators ; information::iterators ; information
information was passed::information was passed
passed through multiple::passed through multiple
multiple stack levels::multiple stack levels
expressions are similar::expressions are similar
similar to languages::similar to languages
behavior of division::behavior of division
mathematics for details::mathematics for details
python also added::python also added
operator for exponentiation::operator for exponentiation
exponentiation in python::exponentiation in python
compares by value::compares by value
contrast to java::contrast to java
compares by reference::compares by reference
comparisons in java::comparisons in java
compare object identities::compare object identities
comparison by reference::comparison by reference
type of expression::type of expression
termed a list::termed a list
list comprehension python::list comprehension python
extended list comprehensions::extended list comprehensions
general expression termed::general expression termed
termed a generator::termed a generator
functions are implemented::functions are implemented
implemented using lambda::implemented using lambda
single expression conditional::single expression conditional
expression conditional expressions::expression conditional expressions
expressions in python::expressions in python
python are written::python are written
order of operands::order of operands
makes a distinction::makes a distinction
distinction between lists::distinction between lists
lists and tuples::lists and tuples
lists are written::lists are written
keys of dictionaries::keys of dictionaries
immutable in python::immutable in python
tuples are written::tuples are written
provided all elements::provided all elements
tuple are immutable::tuple are immutable
immutable the parentheses::immutable the parentheses
tuple are optional::tuple are optional
swap two variables::swap two variables
two variables python::two variables python
format " operator::format " operator
analogous to printf::analogous to printf
printf format strings::printf format strings
e.g " foo::e.g " foo
foo = blah::foo = blah
kinds of string::kinds of string
delimited by single::delimited by single
single or double::single or double
double quotation marks::double quotation marks
unlike in unix::unlike in unix
perl and perl-influenced::perl and perl-influenced
single quotation marks::single quotation marks
marks and double::marks and double
quotation marks function::quotation marks function
marks function identically::marks function identically
identically both kinds::identically both kinds
implicit string interpolation::implicit string interpolation
begin and end::begin and end
span multiple lines::span multiple lines
lines and function::lines and function
documents in shells::documents in shells
perl and ruby::perl and ruby
ruby raw string::ruby raw string
raw string varieties::raw string varieties
denoted by prefixing::denoted by prefixing
prefixing the string::prefixing the string
sequences are interpreted::sequences are interpreted
backslashes are common::backslashes are common
expressions and windows-style::expressions and windows-style
windows-style paths compare::windows-style paths compare
python has index::python has index
index and slice::index and slice
expressions on lists::expressions on lists
indexes are zero-based::indexes are zero-based
indexes are relative::indexes are relative
slices take elements::slices take elements
step or stride::step or stride
skipped and reversed::skipped and reversed
reversed slice indexes::reversed slice indexes
returns a copy::returns a copy
list each element::list each element
copy in python::copy in python
distinction between expressions::distinction between expressions
expressions and statements::expressions and statements
contrast to languages::contrast to languages
ruby this leads::ruby this leads
duplication of functionality::duplication of functionality
comprehensions vs for-loops::comprehensions vs for-loops
for-loops conditional expressions::for-loops conditional expressions
blocks the eval::blocks the eval
comprehensions or lambda::comprehensions or lambda
advantage of avoiding::advantage of avoiding
avoiding a classic::avoiding a classic
classic c error::classic c error
error of mistaking::error of mistaking
mistaking an assignment::mistaking an assignment
valid c code::valid c code
error in python::error in python
methods on objects::methods on objects
objects are functions::objects are functions
object s class::object s class
methods and functions::methods and functions
sugar for class.method::sugar for class.method
explicit self parameter::explicit self parameter
parameter to access::parameter to access
access instance data::access instance data
object-oriented programming languages::object-oriented programming languages
python uses duck::python uses duck
objects but untyped::objects but untyped
untyped variable names::untyped variable names
variable names type::variable names type
names type constraints::names type constraints
checked at compile::checked at compile
object may fail::object may fail
adding a number::adding a number
attempting to make::attempting to make
python allows programmers::python allows programmers
programmers to define::programmers to define
types using classes::types using classes
programming new instances::programming new instances
instances of classes::instances of classes
classes are constructed::classes are constructed
constructed by calling::constructed by calling
calling the class::calling the class
metaprogramming and reflection::metaprogramming and reflection
prior to version::prior to version
kinds of classes::kinds of classes
classes were eliminated::classes were eliminated
eliminated in python::eliminated in python
making all classes::making all classes
new-style in versions::new-style in versions
object is inherited::object is inherited
new-style classes inherit::new-style classes inherit
inherit from object::inherit from object
instances of type::instances of type
summary of python::summary of python
built-in types type::built-in types type
types type description::types type description
type description syntax::type description syntax
syntax example str::syntax example str
str a character::str a character
sequence of unicode::sequence of unicode
unicode codepoints wikipedia::unicode codepoints wikipedia
spanning multiple lines::spanning multiple lines
bytearray a mutable::bytearray a mutable
sequence of bytes::sequence of bytes
bytes an immutable::bytes an immutable
bytes bsome ascii::bytes bsome ascii
ascii " bytes::ascii " bytes
list mutable list::list mutable list
frozenset unordered set::frozenset unordered set
duplicates a frozenset::duplicates a frozenset
frozenset is immutable::frozenset is immutable
dict a mutable::dict a mutable
mutable associative array::mutable associative array
key and value::key and value
keys and values::keys and values
int an immutable::int an immutable
integer of unlimited::integer of unlimited
float an immutable::float an immutable
immutable floating point::immutable floating point
floating point number::floating point number
complex an immutable::complex an immutable
immutable complex number::immutable complex number
number with real::number with real
real and imaginary::real and imaginary
bool an immutable::bool an immutable
immutable boolean value::immutable boolean value
boolean value true::boolean value true
value true false::value true false
true false ellipsis::true false ellipsis
ellipsis an ellipsis::ellipsis an ellipsis
index in numpy::index in numpy
usual c arithmetic::usual c arithmetic
matrix multiply operator::matrix multiply operator
operator @ coming::operator @ coming
division has changed::division has changed
operator is integer::operator is integer
operands are integers::operands are integers
floating point division::floating point division
division otherwise integer::division otherwise integer
integer division rounds::integer division rounds
division to round::division to round
round towards negative::round towards negative
operator is introduced::operator is introduced
adding from __future__::adding from __future__
__future__ import division::__future__ import division
rules for division::rules for division
division in python::division in python
rounding towards negative::rounding towards negative
consistency for instance::consistency for instance
positive and negative::positive and negative
maintaining the validity::maintaining the validity
function for rounding::function for rounding
floats to integers::floats to integers
exact numerical representation::exact numerical representation
rounding modes python::rounding modes python
python allows boolean::python allows boolean
expressions with multiple::expressions with multiple
multiple equality relations::multiple equality relations
consistent with general::consistent with general
usage in mathematics::usage in mathematics
c-derived languages interpret::c-derived languages interpret
interpret this expression::interpret this expression
due to python::due to python
python s extensive::python s extensive
extensive mathematics library::extensive mathematics library
scientific scripting language::scientific scripting language
language to aid::language to aid
aid in problems::aid in problems
processing and manipulation::processing and manipulation
python s greatest::python s greatest
providing tools suited::providing tools suited
philosophy for internet-facing::philosophy for internet-facing
number of standard::number of standard
formats and protocols::formats and protocols
mime and http::mime and http
modules for creating::modules for creating
creating graphical user::creating graphical user
graphical user interfaces::graphical user interfaces
connecting to relational::connecting to relational
pseudorandom number generators::pseudorandom number generators
arithmetic with arbitrary::arithmetic with arbitrary
arbitrary precision decimals::arbitrary precision decimals
manipulating regular expressions::manipulating regular expressions
doing unit testing::doing unit testing
included some parts::included some parts
library are covered::library are covered
covered by specifications::covered by specifications
wsgi implementation wsgiref::wsgi implementation wsgiref
wsgiref follows pep::wsgiref follows pep
library is cross-platform::library is cross-platform
cross-platform python code::cross-platform python code
rewritten by alternative::rewritten by alternative
implementations the standard::implementations the standard
essential to run::essential to run
python or embed::python or embed
python package index::python package index
repository of third-party::repository of third-party
software for python::software for python
54,000 packages offering::54,000 packages offering
offering a wide::offering a wide
range of functionality::range of functionality
networking and communications::networking and communications
communications test frameworks::communications test frameworks
automation and web::automation and web
system administration scientific::system administration scientific
administration scientific computing::administration scientific computing
image processing development::image processing development
processing development environments::processing development environments
comparison of integrated::comparison of integrated
integrated development environments::integrated development environments
environments § python::environments § python
python most python::python most python
command line interpreter::command line interpreter
user enters statements::user enters statements
sequentially and receives::sequentially and receives
receives the results::receives the results
shell other shells::shell other shells
shells add capabilities::shells add capabilities
idle and ipython::idle and ipython
features like auto-completion::features like auto-completion
retention of session::retention of session
highlighting in addition::highlighting in addition
addition to standard::addition to standard
standard desktop python::standard desktop python
desktop python ides::desktop python ides
intended for developing::intended for developing
science and math-related::science and math-related
math-related python programs::math-related python programs
ide and hosting::ide and hosting
list of python::list of python
software § python::software § python
implementations the main::implementations the main
main python implementation::main python implementation
meeting the c89::meeting the c89
compiles python programs::compiles python programs
programs into intermediate::programs into intermediate
cpython is distributed::cpython is distributed
standard library written::standard library written
including microsoft windows::including microsoft windows
modern unix-like systems::modern unix-like systems
unix-like systems cpython::unix-like systems cpython
cpython was intended::cpython was intended
interpreter of python::interpreter of python
just-in-time compiler brings::just-in-time compiler brings
brings a significant::brings a significant
significant speed improvement::significant speed improvement
improvement over cpython::improvement over cpython
version taking advantage::version taking advantage
advantage of multi-core::advantage of multi-core
processors using software::processors using software
software transactional memory::software transactional memory
fork of cpython::fork of cpython
cpython that implements::cpython that implements
allowing massively concurrent::allowing massively concurrent
massively concurrent programs::massively concurrent programs
concurrent programs pypy::concurrent programs pypy
started a project::started a project
project called unladen::project called unladen
aims of increasing::aims of increasing
increasing the speed::increasing the speed
llvm and improving::llvm and improving
improving its multithreading::improving its multithreading
ability to scale::ability to scale
scale to thousands::scale to thousands
thousands of cores::thousands of cores
compiler that integrates::compiler that integrates
integrates with cpython::integrates with cpython
cpython and transforms::cpython and transforms
bytecode to machine::bytecode to machine
code at runtime::code at runtime
runtime the produced::runtime the produced
code is specialised::code is specialised
faster than standard::faster than standard
standard python code::standard python code
released a python::released a python
phones called pys60::phones called pys60
pys60 it includes::pys60 it includes
modules for integration::modules for integration
symbian operating system::symbian operating system
system this project::system this project
date to run::date to run
n900 also supports::n900 also supports
python with gtk::python with gtk
gtk widget libraries::gtk widget libraries
feature that programs::feature that programs
written and run::written and run
compilers to high-level::compilers to high-level
high-level object languages::high-level object languages
subset of python::subset of python
similar to python::similar to python
compiles into java::compiles into java
java byte code::java byte code
java virtual machine::java virtual machine
virtual machine implementation::virtual machine implementation
java class library::java class library
class library functions::class library functions
python program ironpython::python program ironpython
approach in order::approach in order
order to run::order to run
run python programs::run python programs
.net common language::.net common language
common language runtime::common language runtime
runtime the rpython::runtime the rpython
common intermediate language::common intermediate language
build the pypy::build the pypy
python pyjamas compiles::python pyjamas compiles
pyjamas compiles python::pyjamas compiles python
python to javascript::python to javascript
javascript shed skin::javascript shed skin
shed skin compiles::shed skin compiles
skin compiles python::skin compiles python
cython and pyrex::cython and pyrex
workload was presented::workload was presented
presented at euroscipy::presented at euroscipy
python s development::python s development
development is conducted::development is conducted
python enhancement proposal::python enhancement proposal
process the pep::process the pep
mechanism for proposing::mechanism for proposing
collecting community input::collecting community input
documenting the design::documenting the design
peps are reviewed::peps are reviewed
reviewed and commented::reviewed and commented
project s bdfl::project s bdfl
cpython reference implementation::cpython reference implementation
implementation the mailing::implementation the mailing
mailing list python-dev::mailing list python-dev
forum for discussion::forum for discussion
language s development::language s development
development ; specific::development ; specific
issues are discussed::issues are discussed
roundup bug tracker::roundup bug tracker
bug tracker maintained::bug tracker maintained
maintained at python.org::maintained at python.org
development takes place::development takes place
self-hosted source code::self-hosted source code
source code repository::source code repository
code repository running::code repository running
repository running mercurial::repository running mercurial
cpython s public::cpython s public
number is incremented::number is incremented
code is expected::code is expected
expected to break::expected to break
ported the first::ported the first
incremented these releases::incremented these releases
feature " releases::feature " releases
compatible but introduce::compatible but introduce
introduce new features::introduce new features
releases are scheduled::releases are scheduled
scheduled to occur::scheduled to occur
version is supported::version is supported
supported by bugfixes::supported by bugfixes
releases are made::releases are made
number of bugs::number of bugs
months security vulnerabilities::months security vulnerabilities
patched in bugfix::patched in bugfix
number of alpha::number of alpha
released as previews::released as previews
release is made::release is made
ready the development::ready the development
development team monitor::development team monitor
monitor the state::monitor the state
code by running::code by running
running the large::running the large
large unit test::large unit test
unit test suite::unit test suite
suite during development::suite during development
buildbot continuous integration::buildbot continuous integration
continuous integration system::continuous integration system
community of python::community of python
58,000 software modules::58,000 software modules
libraries for python::libraries for python
python the major::python the major
major academic conference::major academic conference
conference on python::conference on python
python is named::python is named
special mentoring programmes::special mentoring programmes
television series monty::television series monty
series monty python::series monty python
monty python references::monty python references
literature are spam::literature are spam
official python documentation::official python documentation
obscure monty python::obscure monty python
references the prefix::references the prefix
related to python::related to python
prefix in names::prefix in names
names of python::names of python
applications or libraries::applications or libraries
libraries include pygame::libraries include pygame
binding of sdl::binding of sdl
sdl to python::sdl to python
symbian s60 operating::symbian s60 operating
s60 operating system::s60 operating system
system ; pyqt::system ; pyqt
pyqt and pygtk::pyqt and pygtk
implementation originally written::implementation originally written
written in python::written in python
popular programming languages::popular programming languages
languages as measured::languages as measured
tiobe programming community::tiobe programming community
programming community index::programming community index
language whose grammatical::language whose grammatical
java an empirical::java an empirical
empirical study found::empirical study found
study found scripting::study found scripting
found scripting languages::found scripting languages
productive than conventional::productive than conventional
programming problem involving::programming problem involving
problem involving string::problem involving string
involving string manipulation::involving string manipulation
manipulation and search::manipulation and search
dictionary memory consumption::dictionary memory consumption
organizations that make::organizations that make
python include google::python include google
python can serve::python can serve
language for web::language for web
apache web server::apache web server
web server gateway::web server gateway
server gateway interface::server gateway interface
api has evolved::api has evolved
evolved to facilitate::evolved to facilitate
facilitate these applications::facilitate these applications
applications web application::applications web application
web application frameworks::web application frameworks
frameworks like django::frameworks like django
flask and zope::flask and zope
zope support developers::zope support developers
design and maintenance::design and maintenance
maintenance of complex::maintenance of complex
complex applications pyjamas::complex applications pyjamas
pyjamas and ironpython::pyjamas and ironpython
develop the client-side::develop the client-side
client-side of ajax-based::client-side of ajax-based
ajax-based applications sqlalchemy::ajax-based applications sqlalchemy
relational database twisted::relational database twisted
framework to program::framework to program
communications between computers::communications between computers
libraries like numpy::libraries like numpy
scipy and matplotlib::scipy and matplotlib
python in scientific::python in scientific
biopython and astropy::biopython and astropy
astropy providing domain-specific::astropy providing domain-specific
providing domain-specific functionality::providing domain-specific functionality
domain-specific functionality sage::domain-specific functionality sage
notebook " programmable::notebook " programmable
programmable in python::programmable in python
covers many aspects::covers many aspects
aspects of mathematics::aspects of mathematics
number of software::number of software
including in finite::including in finite
finite element method::finite element method
element method software::element method software
modeler like freecad::modeler like freecad
visual effects compositor::visual effects compositor
effects compositor nuke::effects compositor nuke
programs like gimp::programs like gimp
scribus and paint::scribus and paint
paint shop pro::paint shop pro
musical notation program::musical notation program
program or scorewriter::program or scorewriter
scorewriter capella gnu::scorewriter capella gnu
capella gnu debugger::capella gnu debugger
debugger uses python::debugger uses python
printer to show::printer to show
show complex structures::show complex structures
containers esri promotes::containers esri promotes
esri promotes python::esri promotes python
choice for writing::choice for writing
scripts in arcgis::scripts in arcgis
adopted as first::adopted as first
languages in google::languages in google
google app engine::google app engine
two being java::two being java
artificial intelligence tasks::artificial intelligence tasks
language with module::language with module
syntax and rich::syntax and rich
rich text processing::rich text processing
text processing tools::text processing tools
natural language processing::natural language processing
language processing tasks::language processing tasks
operating systems include::operating systems include
systems include python::systems include python
terminal a number::terminal a number
number of linux::number of linux
distributions use installers::distributions use installers
red hat linux::red hat linux
linux and fedora::linux and fedora
installer gentoo linux::installer gentoo linux
linux uses python::linux uses python
package management system::package management system
information security industry::information security industry
including in exploit::including in exploit
laptop per child::laptop per child
developed at sugar::developed at sugar
raspberry pi single-board::raspberry pi single-board
single-board computer project::single-board computer project
project has adopted::project has adopted
principal user-programming language::principal user-programming language
user-programming language libreoffice::user-programming language libreoffice
language libreoffice includes::language libreoffice includes
libreoffice includes python::libreoffice includes python
python and intends::python and intends
intends to replace::intends to replace
java with python::java with python
python python scripting::python python scripting
python scripting provider::python scripting provider
python s design::python s design
design and philosophy::design and philosophy
philosophy have influenced::philosophy have influenced
influenced several programming::influenced several programming
boo uses indentation::boo uses indentation
similar object model::similar object model
boo uses static::boo uses static
optional duck typing::optional duck typing
cobra uses indentation::cobra uses indentation
similar syntax cobra::similar syntax cobra
acknowledgements " document::acknowledgements " document
document lists python::document lists python
lists python first::lists python first
first among languages::first among languages
languages that influenced::languages that influenced
cobra directly supports::cobra directly supports
directly supports design-by-contract::directly supports design-by-contract
optional static typing::optional static typing
ecmascript borrowed iterators::ecmascript borrowed iterators
comprehensions from python::comprehensions from python
described as incorporating::described as incorporating
speed of working::speed of working
language like python::language like python
groovy was motivated::groovy was motivated
desire to bring::desire to bring
bring the python::bring the python
python design philosophy::python design philosophy
philosophy to java::philosophy to java
inspired by python::inspired by python
python and haskell::python and haskell
ruby s creator::ruby s creator
wanted a scripting::wanted a scripting
powerful than perl::powerful than perl
object-oriented than python::object-oriented than python
decided to design::decided to design
language that cross-compiles::language that cross-compiles
cross-compiles to javascript::cross-compiles to javascript
python inspired syntax::python inspired syntax
inspired syntax swift::inspired syntax swift
programming language invented::programming language invented
invented by apple::invented by apple
languages the practice::languages the practice
practice of requiring::practice of requiring
requiring a document::requiring a document
describing the rationale::describing the rationale
python s case::python s case
python s influence::python s influence
awarded a tiobe::awarded a tiobe
tiobe programming language::tiobe programming language
growth in popularity::growth in popularity
portal icon free::portal icon free
icon free software::icon free software
free software portal::free software portal
software portal portal::software portal portal
portal portal icon::portal portal icon
portal icon python::portal icon python
icon python programming::icon python programming
python programming portal::python programming portal
programming portal comparison::programming portal comparison
environments for python::environments for python
python for s60::python for s60
s60 off-side rule::s60 off-side rule
off-side rule languages::off-side rule languages
blocks are expressed::blocks are expressed
expressed by indentation::expressed by indentation
comparison of programming::comparison of programming
programming languages list::programming languages list
list of programming::list of programming
programming languages lamp::programming languages lamp
software foundation retrieved::software foundation retrieved
python 2.7.10 release::python 2.7.10 release
python release python::python release python
hinting for python::hinting for python
lwn.net 2014-12-24 retrieved::lwn.net 2014-12-24 retrieved
2015-05-05 ^ jump::2015-05-05 ^ jump
general python faq::general python faq
python faq python::python faq python
faq python software::faq python software
interview with guido::interview with guido
introduction to python::introduction to python
dutch unix users::dutch unix users
unix users group::unix users group
influence on python::influence on python
python is considerable::python is considerable
considerable ^ jump::considerable ^ jump
python tutorial python::python tutorial python
tutorial python software::tutorial python software
class mechanisms found::class mechanisms found
method resolution order::method resolution order
invented by people::invented by people
working on dylan::working on dylan
intended for lispers::intended for lispers
functional programming howto::functional programming howto
python v2.7.2 documentation::python v2.7.2 documentation
v2.7.2 documentation python::v2.7.2 documentation python
documentation python software::documentation python software
neil ; peters::neil ; peters
tim ; hetland::tim ; hetland
python enhancement proposals::python enhancement proposals
enhancement proposals python::enhancement proposals python
proposals python software::proposals python software
skip ; baxter::skip ; baxter
decorators for functions::decorators for functions
functions and methods::functions and methods
control flow tools::control flow tools
perl and python::perl and python
influences in javascript::influences in javascript
axel " chapter::axel " chapter
nature of javascript::nature of javascript
javascript ; influences::javascript ; influences
speaking javascript retrieved::speaking javascript retrieved
julia website february::julia website february
jruby on rails::jruby on rails
ruby on rails::ruby on rails
java platform berkeley::java platform berkeley
isbn 978-1-59059-881-8 jump::isbn 978-1-59059-881-8 jump
lattner s homepage::lattner s homepage
chris lattner retrieved::chris lattner retrieved
product of tireless::product of tireless
team of language::team of language
compiler optimization ninjas::compiler optimization ninjas
incredibly important internal::incredibly important internal
important internal dogfooding::important internal dogfooding
internal dogfooding group::internal dogfooding group
group who provided::group who provided
refine and battle-test::refine and battle-test
ideas from objective-c::ideas from objective-c
list ^ jump::list ^ jump
tiobe software index::tiobe software index
community index python::community index python
programming language trends::programming language trends
redmonk programming language::redmonk programming language
programming language rankings::programming language rankings
mark rapid gui::mark rapid gui
rapid gui programming::rapid gui programming
programming with python::programming with python
write far fewer::write far fewer
lines of python::lines of python
equivalent application written::equivalent application written
section " fans::section " fans
fans of python::fans of python
phrase " batteries::phrase " batteries
describe the standard::describe the standard
processing to zip::processing to zip
files " jump::files " jump
pyinstaller home page::pyinstaller home page
making of python::making of python
artima developer artima::artima developer artima
developer artima retrieved::developer artima retrieved
timeline of python::timeline of python
python google retrieved::python google retrieved
lukewarm about range::lukewarm about range
special method names::special method names
python language reference::python language reference
language reference python::language reference python
reference python software::reference python software
postconditions and class::postconditions and class
invariants for python::invariants for python
contracts for python::contracts for python
itertools – functions::itertools – functions
functions creating iterators::functions creating iterators
iterators for efficient::iterators for efficient
data pretty printer::data pretty printer
david " code::david " code
python a good::python a good
language for beginning::language for beginning
myths about indentation::myths about indentation
indentation in python::indentation in python
differences between python::differences between python
games with python::games with python
isbn 978-0-9821060-1-3 retrieved::isbn 978-0-9821060-1-3 retrieved
tail recursion elimination::tail recursion elimination
artima forums artima::artima forums artima
forums artima retrieved::forums artima retrieved
guido ; eby::guido ; eby
coroutines via enhanced::coroutines via enhanced
guido ; hettinger::guido ; hettinger
explicitly in method::explicitly in method
definitions and calls::definitions and calls
design and history::design and history
history faq python::history faq python
new-style and classic::new-style and classic
moshe ; van::moshe ; van
unifying long integers::unifying long integers
integers and integers::integers and integers
dedicated infix operator::dedicated infix operator
operator for matrix::operator for matrix
changing the division::changing the division
python s integer::python s integer
integer division floors::integer division floors
python standard library::python standard library
python essential reference::python essential reference
david m beazley::david m beazley
build a rapid::build a rapid
rapid web development::rapid web development
web development environment::web development environment
environment for python::environment for python
python server pages::python server pages
pages and oracle::pages and oracle
oracle technology network::oracle technology network
technology network oracle::technology network oracle
network oracle retrieved::network oracle retrieved
decimal data type::decimal data type
python web server::python web server
cpython byte code::cpython byte code
comparison between cpython::comparison between cpython
cpython and pypy::cpython and pypy
stm with threads::stm with threads
application-level stackless features::application-level stackless features
features — pypy::features — pypy
pypy 2.0.2 documentation::pypy 2.0.2 documentation
plans for optimizing::plans for optimizing
google project hosting::google project hosting
project hosting google::project hosting google
stochastic geometry jump::stochastic geometry jump
performance of python::performance of python
non-numeric scientific code::non-numeric scientific code
scientific code european::scientific code european
code european conference::code european conference
python in science::python in science
barry ; hylton::barry ; hylton
jeremy ; goodger::jeremy ; goodger
purpose and guidelines::purpose and guidelines
brett " guido::brett " guido
python is developed::python is developed
python.org python software::python.org python software
developer s guide::developer s guide
stability & change::stability & change
aahz ; baxter::aahz ; baxter
bug fix releases::bug fix releases
guide python software::guide python software
python v2.7.3 documentation::python v2.7.3 documentation
v2.7.3 documentation docs.python.org::v2.7.3 documentation docs.python.org
documentation docs.python.org retrieved::documentation docs.python.org retrieved
whetting your appetite::whetting your appetite
stack overflow stack::stack overflow stack
overflow stack exchange::overflow stack exchange
bibliography of lutz::bibliography of lutz
lutz prechelt retrieved::lutz prechelt retrieved
quotes about python::quotes about python
organizations using python::organizations using python
grail of programming::grail of programming
python streamlines space::python streamlines space
streamlines space shuttle::streamlines space shuttle
space shuttle mission::space shuttle mission
shuttle mission design::shuttle mission design
light & magic::light & magic
runs on python::runs on python
slithers into systems::slithers into systems
eweek.com ziff davis::eweek.com ziff davis
ziff davis holdings::ziff davis holdings
davis holdings retrieved::davis holdings retrieved
statistics and market::statistics and market
share of python::share of python
python for websites::python for websites
python for scientific::python for scientific
computing in science::computing in science
science and engineering::science and engineering
jarrod ; aivazis::jarrod ; aivazis
python for scientists::python for scientists
scientists and engineers::scientists and engineers
installers for gimp::installers for gimp
gimp for windows::gimp for windows
frequently asked questions::frequently asked questions
started with writing::started with writing
writing geoprocessing scripts::writing geoprocessing scripts
environmental systems research::environmental systems research
systems research institute::systems research institute
eve community dev::eve community dev
community dev blogs::community dev blogs
dev blogs ccp::dev blogs ccp
blogs ccp games::blogs ccp games
core the programming::core the programming
stackless python jump::stackless python jump
modding sid meier::modding sid meier
meier s civilization::meier s civilization
civilization iv developer::civilization iv developer
developer blog firaxis::developer blog firaxis
blog firaxis games::blog firaxis games
firaxis games archived::firaxis games archived
created three levels::created three levels
levels of tools::levels of tools
level offers python::level offers python
python and xml::python and xml
manipulate the game::manipulate the game
python language guide::python language guide
google documents list::google documents list
documents list data::documents list data
list data api::list data api
data api v1.0::data api v1.0
api v1.0 google::api v1.0 google
v1.0 google archived::v1.0 google archived
python for artificial::python for artificial
upper saddle river::upper saddle river
isbn 978-0-13-604259-4 retrieved::isbn 978-0-13-604259-4 retrieved
natural language toolkit::natural language toolkit
knowing you re::knowing you re
sugar labs retrieved::sugar labs retrieved
features and fixes::features and fixes
libreoffice.org the document::libreoffice.org the document
gotchas for python::gotchas for python
boo.codehaus.org codehaus foundation::boo.codehaus.org codehaus foundation
codehaus foundation retrieved::codehaus foundation retrieved
charles " acknowledgements::charles " acknowledgements
cobra-language.com cobra language::cobra-language.com cobra language
cobra language retrieved::cobra language retrieved
charles " comparison::charles " comparison
comparison to python::comparison to python
iterators and generators::iterators and generators
thing for ocaml::thing for ocaml
institute of technology::institute of technology
creator of ruby::creator of ruby
swift programming language::swift programming language
basic language structure::basic language structure
people started contributing::people started contributing
contributing in earnest::contributing in earnest
apple developer tools::apple developer tools
developer tools group::developer tools group
andreas ; fellows::andreas ; fellows
tcl.tk tcl developer::tcl.tk tcl developer
tcl developer xchange::tcl developer xchange
developer xchange retrieved::developer xchange retrieved
index for march::index for march
tiobe software march::tiobe software march
isbn 978-0-521-72596-5 hamilton::isbn 978-0-521-72596-5 hamilton
a-z of programming::a-z of programming
oreilly media isbn::oreilly media isbn
isbn 978-0-596-15806-4 pilgrim::isbn 978-0-596-15806-4 pilgrim
dive into python::dive into python
python apress isbn::python apress isbn
isbn 978-1-59059-356-1 pilgrim::isbn 978-1-59059-356-1 pilgrim
isbn 978-1-4302-2415-0 summerfield::isbn 978-1-4302-2415-0 summerfield
programming in python::programming in python
addison-wesley professional isbn::addison-wesley professional isbn
isbn 978-0-321-68056-3 external::isbn 978-0-321-68056-3 external
978-0-321-68056-3 external links::978-0-321-68056-3 external links
wikipedia s sister::wikipedia s sister
sister projects search::sister projects search
projects search commons::projects search commons
search commons media::search commons media
media from commons::media from commons
commons search wikiquote::commons search wikiquote
search wikiquote quotations::search wikiquote quotations
quotations from wikiquote::quotations from wikiquote
wikiquote search wikibooks::wikiquote search wikibooks
search wikibooks textbooks::search wikibooks textbooks
textbooks from wikibooks::textbooks from wikibooks
wikibooks search wikiversity::wikibooks search wikiversity
search wikiversity learning::search wikiversity learning
wikiversity learning resources::wikiversity learning resources
resources from wikiversity::resources from wikiversity
wikiversity official website::wikiversity official website
official website python::official website python
newsgroup on usenet::newsgroup on usenet
alternative free web::alternative free web
free web access::free web access
access using google::access using google
blog by guido::blog by guido
python development list::python development list
development list python::development list python
python at dmoz::python at dmoz
python web application::python web application
open-source software categories::open-source software categories
class-based programming languagescross-platform::class-based programming languagescross-platform
programming languagescross-platform free::programming languagescross-platform free
languagescross-platform free softwaredutch::languagescross-platform free softwaredutch
softwaredutch inventionsdynamically typed::softwaredutch inventionsdynamically typed
inventionsdynamically typed programming::inventionsdynamically typed programming
typed programming languageshigh-level::typed programming languageshigh-level
programming languageshigh-level programming::programming languageshigh-level programming
languageshigh-level programming languagesobject-oriented::languageshigh-level programming languagesobject-oriented
programming languagesobject-oriented programming::programming languagesobject-oriented programming
languagesobject-oriented programming languagesprogramming::languagesobject-oriented programming languagesprogramming
programming languagesprogramming languages::programming languagesprogramming languages
languagesprogramming languages created::languagesprogramming languages created
scripting languagestext-oriented programming::scripting languagestext-oriented programming
languagestext-oriented programming languages::languagestext-oriented programming languages
programming languages navigation::programming languages navigation
languages navigation menu::languages navigation menu
navigation menu create::navigation menu create
menu create accountlog::menu create accountlog
create accountlog inarticletalkreadeditview::create accountlog inarticletalkreadeditview
accountlog inarticletalkreadeditview history::accountlog inarticletalkreadeditview history
inarticletalkreadeditview history main::inarticletalkreadeditview history main
history main page::history main page
main page contents::main page contents
page contents featured::page contents featured
contents featured content::contents featured content
featured content current::featured content current
content current events::content current events
current events random::current events random
events random article::events random article
random article donate::random article donate
donate to wikipedia::donate to wikipedia
wikipedia store interaction::wikipedia store interaction
wikipedia community portal::wikipedia community portal
community portal recent::community portal recent
recent changes contact::recent changes contact
contact page tools::contact page tools
tools what links::tools what links
links here related::links here related
upload file special::upload file special
file special pages::file special pages
special pages permanent::special pages permanent
pages permanent link::pages permanent link
permanent link page::permanent link page
link page information::link page information
page information wikidata::page information wikidata
information wikidata item::information wikidata item
wikidata item cite::wikidata item cite
cite this page::cite this page
page print create::page NN create
create a book::create a book
download as pdf::download as pdf
pdf printable version::pdf printable version
printable version languages::printable version languages
version languages afrikaans::version languages afrikaans
languages afrikaans alemannisch::languages afrikaans alemannisch
afrikaans alemannisch aragon::afrikaans alemannisch aragon
n-l â m-g::n-l â m-g
m-g ú bosanski::m-g ú bosanski
catal à cebuano::catal à cebuano
tina dansk deutsch::tina dansk deutsch
dansk deutsch eesti::dansk deutsch eesti
deutsch eesti espa::deutsch eesti espa
esperanto euskara fran::esperanto euskara fran
fran ç ais::fran ç ais
ais galego hrvatski::ais galego hrvatski
galego hrvatski bahasa::galego hrvatski bahasa
hrvatski bahasa indonesia::hrvatski bahasa indonesia
bahasa indonesia interlingua::bahasa indonesia interlingua
interlingua Í slenska::interlingua Í slenska
slenska italiano latina::slenska italiano latina
italiano latina latvie::italiano latina latvie
lietuvi lojban magyar::lietuvi lojban magyar
lojban magyar bahasa::lojban magyar bahasa
magyar bahasa melayu::magyar bahasa melayu
bahasa melayu nederlands::bahasa melayu nederlands
melayu nederlands norsk::melayu nederlands norsk
nederlands norsk bokm::nederlands norsk bokm
tsch polski portugu::tsch polski portugu
shqip simple english::shqip simple english
english sloven ina::english sloven ina
sloven š ina::sloven š ina
suomi svenska tagalog::suomi svenska tagalog
links this page::links this page
page was last::page was last
creative commons attribution-sharealike::creative commons attribution-sharealike
commons attribution-sharealike license::commons attribution-sharealike license
license ; additional::license ; additional
terms may apply::terms may apply
privacy policy wikipedia::privacy policy wikipedia
non-profit organization privacy::non-profit organization privacy
privacy policyabout wikipediadisclaimerscontact::privacy policyabout wikipediadisclaimerscontact
policyabout wikipediadisclaimerscontact wikipediadevelopersmobile::policyabout wikipediadisclaimerscontact wikipediadevelopersmobile
wikipediadisclaimerscontact wikipediadevelopersmobile viewwikimedia::wikipediadisclaimerscontact wikipediadevelopersmobile viewwikimedia
wikipediadevelopersmobile viewwikimedia foundation::wikipediadevelopersmobile viewwikimedia foundation
viewwikimedia foundation powered::viewwikimedia foundation powered
good article::good article
article click::article click
information python::information python
programming language::programming language
free encyclopedia::free encyclopedia
encyclopedia python::encyclopedia python
python python::python python
python logo::python logo
wordmark.svg paradigm::wordmark.svg paradigm
paradigm multi-paradigm::paradigm multi-paradigm
guido van::guido van
van rossum::van rossum
rossum developer::rossum developer
developer python::developer python
python software::python software
software foundation::software foundation
stable release::stable release
preview release::preview release
typing discipline::typing discipline
discipline duck::discipline duck
cross-platform license::cross-platform license
license python::license python
foundation license::foundation license
license filename::license filename
filename extensions::filename extensions
.pyw website::.pyw website
major implementations::major implementations
implementations cpython::implementations cpython
pypy dialects::pypy dialects
dialects cython::dialects cython
stackless python::stackless python
python influenced::python influenced
perl influenced::perl influenced
python programming::python programming
wikibooks python::wikibooks python
high-level programming::high-level programming
design philosophy::design philosophy
philosophy emphasizes::philosophy emphasizes
emphasizes code::emphasizes code
code readability::code readability
express concepts::express concepts
fewer lines::fewer lines
constructs intended::constructs intended
enable clear::enable clear
clear programs::clear programs
large scale::large scale
python supports::python supports
supports multiple::supports multiple
programming paradigms::programming paradigms
functional programming::functional programming
procedural styles::procedural styles
dynamic type::dynamic type
type system::type system
automatic memory::automatic memory
memory management::memory management
comprehensive standard::comprehensive standard
standard library::standard library
python interpreters::python interpreters
operating systems::operating systems
allowing python::allowing python
python code::python code
code execution::code execution
wide variety::wide variety
third-party tools::third-party tools
stand-alone executable::stand-alone executable
executable programs::executable programs
popular operating::popular operating
python-based software::python-based software
python interpreter::python interpreter
interpreter cpython::interpreter cpython
reference implementation::reference implementation
open-source software::open-source software
community-based development::community-based development
development model::development model
alternative implementations::alternative implementations
non-profit python::non-profit python
foundation contents::foundation contents
control flow::control flow
development environments::development environments
languages influenced::languages influenced
external links::external links
links history::links history
python main::python main
main article::main article
abc language::abc language
exception handling::exception handling
amoeba operating::amoeba operating
operating system::operating system
principal author::principal author
central role::central role
python community::python community
benevolent dictator::benevolent dictator
rossum wrote::rossum wrote
programming project::programming project
home computer::home computer
scripting language::scripting language
chose python::chose python
working title::working title
irreverent mood::irreverent mood
big fan::big fan
monty python::monty python
flying circus::flying circus
features including::features including
full garbage::full garbage
garbage collector::garbage collector
development process::development process
backwards-incompatible release::backwards-incompatible release
long period::long period
major features::major features
backwards-compatible python::backwards-compatible python
multi-paradigm programming::multi-paradigm programming
object-oriented programming::object-oriented programming
structured programming::structured programming
language features::language features
aspect-oriented programming::aspect-oriented programming
magic methods::magic methods
including design::including design
logic programming::logic programming
dynamic typing::dynamic typing
reference counting::reference counting
cycle-detecting garbage::cycle-detecting garbage
important feature::important feature
late binding::late binding
binds method::binds method
variable names::variable names
program execution::program execution
python offers::python offers
lisp tradition::lisp tradition
generator expressions::generator expressions
functional tools::functional tools
tools borrowed::tools borrowed
core philosophy::core philosophy
includes aphorisms::includes aphorisms
implicit simple::implicit simple
complex complex::complex complex
complicated readability::complicated readability
readability counts::readability counts
desired functionality::desired functionality
highly extensible::highly extensible
extensible python::extensible python
existing applications::existing applications
programmable interface::programmable interface
small core::small core
core language::core language
large standard::large standard
extensible interpreter::extensible interpreter
opposite mindset::opposite mindset
offering choice::offering choice
coding methodology::coding methodology
python philosophy::python philosophy
philosophy rejects::philosophy rejects
rejects exuberant::rejects exuberant
exuberant syntax::exuberant syntax
less-cluttered grammar::less-cluttered grammar
alex martelli::alex martelli
martelli put::martelli put
python culture::python culture
language design::language design
developers strive::developers strive
avoid premature::avoid premature
premature optimization::premature optimization
reject patches::reject patches
non-critical parts::non-critical parts
marginal increase::marginal increase
python programmers::python programmers
just-in-time compiler::just-in-time compiler
time-critical functions::time-critical functions
extension modules::extension modules
modules written::modules written
python script::python script
level api::level api
api calls::api calls
important goal::important goal
python developers::python developers
making python::making python
python fun::python fun
playful approach::playful approach
reference materials::reference materials
standard foo::standard foo
common neologism::common neologism
wide range::wide range
meanings related::meanings related
program style::program style
python idioms::python idioms
shows fluency::shows fluency
minimalist philosophy::minimalist philosophy
rough transcription::rough transcription
python syntax::python syntax
semantics python::semantics python
readable language::readable language
english keywords::english keywords
smaller number::smaller number
syntactic exceptions::syntactic exceptions
special cases::special cases
indentation python::indentation python
whitespace indentation::whitespace indentation
curly braces::curly braces
delimit blocks::delimit blocks
off-side rule::off-side rule
indentation signifies::indentation signifies
current block::current block
statements include::statements include
iterable object::iterable object
local variable::local variable
attached block::attached block
exceptions raised::exceptions raised
attached code::attached code
code block::code block
clean-up code::clean-up code
finally block::finally block
block exits::block exits
class statement::class statement
local namespace::local namespace
def statement::def statement
context manager::context manager
raii-like behavior::raii-like behavior
pass statement::pass statement
empty code::empty code
assert statement::assert statement
yield statement::yield statement
generator function::generator function
implement coroutines::implement coroutines
import statement::import statement
import modules::import modules
current program::current program
print statement::print statement
tail-call optimization::tail-call optimization
first-class continuations::first-class continuations
coroutine-like functionality::coroutine-like functionality
extending python::extending python
lazy iterators::lazy iterators
pass information::pass information
multiple stack::multiple stack
stack levels::stack levels
python expressions::python expressions
division differs::division differs
value comparisons::value comparisons
object identities::object identities
boolean operators::boolean operators
expression termed::expression termed
list comprehension::list comprehension
comprehension python::comprehension python
extended list::extended list
list comprehensions::list comprehensions
general expression::general expression
generator expression::generator expression
anonymous functions::anonymous functions
lambda expressions::lambda expressions
single expression::single expression
conditional expressions::conditional expressions
python makes::python makes
tuples lists::tuples lists
dictionary keys::dictionary keys
contexts tuples::contexts tuples
left side::left side
equal sign::equal sign
variables python::variables python
string format::string format
functions analogous::functions analogous
printf format::printf format
format strings::format strings
blah bar::blah bar
str class::str class
string literals::string literals
strings delimited::strings delimited
double quotation::double quotation
quotation marks::quotation marks
unix shells::unix shells
perl-influenced languages::perl-influenced languages
single quotation::single quotation
marks function::marks function
function identically::function identically
escape character::escape character
implicit string::implicit string
string interpolation::string interpolation
triple-quoted strings::triple-quoted strings
span multiple::span multiple
multiple lines::multiple lines
ruby raw::ruby raw
raw string::raw string
string varieties::string varieties
escape sequences::escape sequences
raw strings::raw strings
literal backslashes::literal backslashes
regular expressions::regular expressions
windows-style paths::windows-style paths
paths compare::paths compare
slice expressions::slice expressions
negative indexes::negative indexes
end slices::end slices
start index::start index
stop index::stop index
slice parameter::slice parameter
reversed slice::reversed slice
slice indexes::slice indexes
entire list::entire list
shallow copy::shallow copy
common lisp::common lisp
built-in functions::built-in functions
statements statements::statements statements
assignment statement::assignment statement
form part::form part
conditional expression::conditional expression
conditional statement::conditional statement
assignment operator::assignment operator
equality operator::equality operator
syntax error::syntax error
python methods::python methods
functions attached::functions attached
syntax instance.method::syntax instance.method
normal methods::normal methods
syntactic sugar::syntactic sugar
access instance::access instance
instance data::instance data
programming languages::programming languages
typed objects::typed objects
names type::names type
type constraints::type constraints
suitable type::suitable type
forbidding operations::forbidding operations
make sense::make sense
metaclass type::metaclass type
allowing metaprogramming::allowing metaprogramming
old-style classes::old-style classes
classes new-style::classes new-style
class object::class object
new-style classes::new-style classes
classes inherit::classes inherit
built-in types::built-in types
types type::types type
type description::type description
description syntax::description syntax
character string::character string
immutable sequence::immutable sequence
unicode codepoints::unicode codepoints
codepoints wikipedia::codepoints wikipedia
spanning multiple::spanning multiple
mutable sequence::mutable sequence
bytes bytearray::bytes bytearray
bsome ascii::bsome ascii
bytes bsome::bytes bsome
mutable list::mutable list
mixed types::mixed types
frozenset unordered::frozenset unordered
mutable associative::mutable associative
associative array::associative array
value pairs::value pairs
hashable type::hashable type
immutable integer::immutable integer
unlimited magnitude::unlimited magnitude
immutable floating::immutable floating
floating point::floating point
point number::point number
system-defined precision::system-defined precision
immutable complex::immutable complex
complex number::complex number
imaginary parts::imaginary parts
immutable boolean::immutable boolean
boolean value::boolean value
value true::value true
true false::true false
false ellipsis::false ellipsis
ellipsis placeholder::ellipsis placeholder
numpy arrays::numpy arrays
arithmetic operators::arithmetic operators
multiply operator::multiply operator
division behavior::division behavior
integer division::integer division
point division::point division
division rounds::division rounds
floor division::floor division
__future__ import::__future__ import
import division::import division
python terms::python terms
classic division::classic division
real division::real division
adds consistency::adds consistency
negative values::negative values
equation means::equation means
half-open interval::half-open interval
positive integer::positive integer
round function::round function
rounding floats::rounding floats
integers versions::integers versions
module decimal::module decimal
exact numerical::exact numerical
numerical representation::numerical representation
rounding modes::rounding modes
modes python::modes python
boolean expressions::boolean expressions
multiple equality::multiple equality
equality relations::equality relations
general usage::general usage
c-derived languages::c-derived languages
languages interpret::languages interpret
page needed::page needed
extensive mathematics::extensive mathematics
scientific scripting::scientific scripting
data processing::data processing
manipulation libraries::manipulation libraries
greatest strengths::greatest strengths
providing tools::providing tools
tools suited::tools suited
batteries included::batteries included
internet-facing applications::internet-facing applications
large number::large number
standard formats::standard formats
supported modules::supported modules
graphical user::graphical user
user interfaces::user interfaces
relational databases::relational databases
pseudorandom number::pseudorandom number
number generators::number generators
arbitrary precision::arbitrary precision
precision decimals::precision decimals
doing unit::doing unit
unit testing::unit testing
wsgi implementation::wsgi implementation
implementation wsgiref::implementation wsgiref
internal documentation::internal documentation
test suite::test suite
cross-platform python::cross-platform python
run python::run python
embed python::embed python
application blender::application blender
python package::python package
package index::package index
official repository::official repository
third-party software::third-party software
packages offering::packages offering
web frameworks::web frameworks
communications test::communications test
test frameworks::test frameworks
web scraping::web scraping
documentation tools::documentation tools
system administration::system administration
administration scientific::administration scientific
scientific computing::scientific computing
text processing::text processing
image processing::image processing
processing development::processing development
integrated development::integrated development
python implementations::python implementations
including cpython::including cpython
command line::command line
line interpreter::line interpreter
user enters::user enters
enters statements::enters statements
python acts::python acts
shells add::shells add
add capabilities::add capabilities
basic interpreter::basic interpreter
including idle::including idle
visual style::visual style
python shell::python shell
implement features::implement features
session state::session state
syntax highlighting::syntax highlighting
desktop python::desktop python
python ides::python ides
browser-based ides::browser-based ides
developing science::developing science
math-related python::math-related python
python programs::python programs
browser-based ide::browser-based ide
hosting environment::hosting environment
pythonanywhere implementations::pythonanywhere implementations
main python::main python
python implementation::python implementation
named cpython::named cpython
c89 standard::c89 standard
compiles python::compiles python
intermediate bytecode::intermediate bytecode
virtual machine::virtual machine
library written::library written
including microsoft::including microsoft
microsoft windows::microsoft windows
modern unix-like::modern unix-like
unix-like systems::unix-like systems
systems cpython::systems cpython
compiler brings::compiler brings
significant speed::significant speed
speed improvement::speed improvement
version taking::version taking
taking advantage::taking advantage
multi-core processors::multi-core processors
transactional memory::transactional memory
significant fork::significant fork
implements microthreads::implements microthreads
memory stack::memory stack
concurrent programs::concurrent programs
programs pypy::programs pypy
stackless version::stackless version
just-in-time compilers::just-in-time compilers
unladen swallow::unladen swallow
multithreading ability::multithreading ability
transforms bytecode::transforms bytecode
machine code::machine code
produced code::produced code
data types::data types
standard python::standard python
nokia released::nokia released
mobile phones::mobile phones
cpython implementations::cpython implementations
additional modules::additional modules
symbian operating::symbian operating
s60 platform::s60 platform
party modules::party modules
nokia n900::nokia n900
supports python::supports python
gtk widget::gtk widget
widget libraries::widget libraries
high-level object::high-level object
object languages::object languages
unrestricted python::unrestricted python
restricted subset::restricted subset
source language::source language
jython compiles::jython compiles
java byte::java byte
byte code::byte code
machine implementation::machine implementation
java class::java class
class library::class library
library functions::library functions
python program::python program
program ironpython::program ironpython
similar approach::similar approach
.net common::.net common
common language::common language
language runtime::language runtime
rpython language::rpython language
java bytecode::java bytecode
common intermediate::common intermediate
intermediate language::intermediate language
pypy interpreter::pypy interpreter
pyjamas compiles::pyjamas compiles
javascript shed::javascript shed
shed skin::shed skin
skin compiles::skin compiles
pyrex compile::pyrex compile
performance comparison::performance comparison
euroscipy 13::euroscipy 13
python enhancement::python enhancement
enhancement proposal::enhancement proposal
pep process::pep process
primary mechanism::primary mechanism
collecting community::collecting community
community input::community input
design decisions::design decisions
outstanding peps::outstanding peps
python project::python project
cpython reference::cpython reference
mailing list::mailing list
list python-dev::list python-dev
primary forum::primary forum
specific issues::specific issues
roundup bug::roundup bug
bug tracker::bug tracker
tracker maintained::tracker maintained
development takes::development takes
takes place::takes place
self-hosted source::self-hosted source
source code::source code
code repository::code repository
repository running::repository running
running mercurial::running mercurial
public releases::public releases
version number::version number
backwards-incompatible versions::backwards-incompatible versions
manually ported::manually ported
first part::first part
releases happen::releases happen
major version::major version
final part::final part
sufficient number::sufficient number
fixed upstream::fixed upstream
last release::last release
months security::months security
security vulnerabilities::security vulnerabilities
bugfix releases::bugfix releases
final release::final release
rough schedule::rough schedule
development team::development team
team monitor::team monitor
large unit::large unit
unit test::unit test
continuous integration::continuous integration
integration system::integration system
software modules::software modules
third-party libraries::third-party libraries
major academic::major academic
academic conference::academic conference
special mentoring::special mentoring
mentoring programmes::mentoring programmes
pyladies naming::pyladies naming
television series::television series
series monty::series monty
python references::python references
metasyntactic variables::metasyntactic variables
python literature::python literature
traditional foo::traditional foo
official python::official python
python documentation::python documentation
obscure monty::obscure monty
prefix py::prefix py-
python examples::python examples
python applications::python applications
libraries include::libraries include
include pygame::include pygame
create games::create games
symbian s60::symbian s60
s60 operating::s60 operating
popular programming::popular programming
tiobe programming::tiobe programming
programming community::programming community
community index::community index
popular language::popular language
grammatical syntax::grammatical syntax
empirical study::empirical study
study found::study found
scripting languages::scripting languages
conventional languages::conventional languages
programming problem::programming problem
problem involving::problem involving
involving string::involving string
string manipulation::string manipulation
dictionary memory::dictionary memory
memory consumption::memory consumption
large organizations::large organizations
python include::python include
include google::include google
web applications::web applications
apache web::apache web
web server::web server
server gateway::server gateway
gateway interface::gateway interface
standard api::standard api
applications web::applications web
web application::web application
application frameworks::application frameworks
zope support::zope support
support developers::support developers
complex applications::complex applications
applications pyjamas::applications pyjamas
ajax-based applications::ajax-based applications
applications sqlalchemy::applications sqlalchemy
relational database::relational database
database twisted::database twisted
program communications::program communications
dropbox libraries::dropbox libraries
specialized libraries::specialized libraries
astropy providing::astropy providing
domain-specific functionality::domain-specific functionality
functionality sage::functionality sage
mathematical software::mathematical software
library covers::library covers
including algebra::including algebra
numerical mathematics::numerical mathematics
number theory::number theory
calculus python::calculus python
software products::software products
finite element::finite element
element method::element method
method software::method software
parametric modeler::parametric modeler
animation packages::animation packages
visual effects::visual effects
effects compositor::effects compositor
compositor nuke::compositor nuke
imaging programs::imaging programs
paint shop::paint shop
shop pro::shop pro
musical notation::musical notation
notation program::notation program
scorewriter capella::scorewriter capella
capella gnu::capella gnu
gnu debugger::gnu debugger
pretty printer::pretty printer
complex structures::complex structures
containers esri::containers esri
esri promotes::esri promotes
promotes python::promotes python
writing scripts::writing scripts
video games::video games
google app::google app
app engine::app engine
artificial intelligence::artificial intelligence
intelligence tasks::intelligence tasks
module architecture::module architecture
simple syntax::simple syntax
rich text::rich text
processing tools::processing tools
natural language::natural language
language processing::language processing
processing tasks::processing tasks
systems include::systems include
include python::include python
standard component::standard component
language ships::language ships
linux distributions::linux distributions
installers written::installers written
ubiquity installer::ubiquity installer
red hat::red hat
hat linux::hat linux
anaconda installer::anaconda installer
gentoo linux::gentoo linux
package management::package management
management system::management system
portage python::portage python
information security::information security
security industry::security industry
exploit development::exploit development
sugar software::sugar software
sugar labs::sugar labs
single-board computer::single-board computer
computer project::computer project
adopted python::adopted python
principal user-programming::principal user-programming
user-programming language::user-programming language
language libreoffice::language libreoffice
libreoffice includes::libreoffice includes
includes python::includes python
replace java::replace java
python scripting::python scripting
scripting provider::scripting provider
core feature::core feature
similar syntax::similar syntax
similar object::similar object
object model::object model
static typing::static typing
optional duck::optional duck
duck typing::duck typing
.net framework::.net framework
syntax cobra::syntax cobra
document lists::document lists
lists python::lists python
unit tests::unit tests
optional static::optional static
ecmascript borrowed::ecmascript borrowed
borrowed iterators::borrowed iterators
development speed::development speed
dynamic language::dynamic language
python design::python design
optional syntax::optional syntax
whitespace thing::whitespace thing
yukihiro matsumoto::yukihiro matsumoto
inspired syntax::inspired syntax
syntax swift::syntax swift
language invented::language invented
python inspired::python inspired
development practices::development practices
document describing::document describing
issues surrounding::issues surrounding
influence python::influence python
year award::year award
greatest growth::greatest growth
tiobe index::tiobe index
portal icon::portal icon
free software::free software
software portal::software portal
portal portal::portal portal
icon python::icon python
programming portal::programming portal
portal comparison::portal comparison
rule languages::rule languages
indentation comparison::indentation comparison
languages list::languages list
languages lamp::languages lamp
software bundle::software bundle
foundation retrieved::foundation retrieved
python release::python release
release python::release python
type hinting::type hinting
first place::first place
general python::general python
python faq::python faq
faq python::faq python
amk.ca retrieved::amk.ca retrieved
nluug najaarsconferentie::nluug najaarsconferentie
dutch unix::dutch unix
unix users::unix users
users group::users group
python tutorial::python tutorial
tutorial python::tutorial python
class mechanisms::class mechanisms
mechanisms found::mechanisms found
method resolution::method resolution
resolution order::resolution order
people working::people working
paper intended::paper intended
lispers jump::lispers jump
programming howto::programming howto
documentation python::documentation python
magnus lie::magnus lie
simple generators::simple generators
enhancement proposals::enhancement proposals
proposals python::proposals python
flow tools::flow tools
python influences::python influences
tha nature::tha nature
speaking javascript::speaking javascript
javascript retrieved::javascript retrieved
created julia::created julia
julia website::julia website
website february::website february
practical jruby::practical jruby
rails web::rails web
bringing ruby::bringing ruby
java platform::java platform
platform berkeley::platform berkeley
chris lattner::chris lattner
lattner retrieved::lattner retrieved
swift language::swift language
tireless effort::tireless effort
language experts::language experts
documentation gurus::documentation gurus
compiler optimization::compiler optimization
optimization ninjas::optimization ninjas
important internal::important internal
internal dogfooding::internal dogfooding
dogfooding group::dogfooding group
battle-test ideas::battle-test ideas
drawing ideas::drawing ideas
tiobe software::tiobe software
software index::software index
index python::index python
language trends::language trends
redmonk programming::redmonk programming
language rankings::language rankings
mark rapid::mark rapid
rapid gui::rapid gui
gui programming::gui programming
expressive language::expressive language
equivalent application::equivalent application
application written::application written
java jump::java jump
code complete::code complete
python book::python book
beginning python::beginning python
advanced python::advanced python
python exercises::python exercises
asynchronous processing::asynchronous processing
zip files::zip files
pyinstaller home::pyinstaller home
home page::home page
artima developer::artima developer
developer artima::developer artima
artima retrieved::artima retrieved
python google::python google
google retrieved::google retrieved
range literals::range literals
programming python::programming python
cain gang::cain gang
python metaclasses::python metaclasses
special method::special method
method names::method names
python language::python language
language reference::language reference
reference python::reference python
method preconditions::method preconditions
method postconditions::method postconditions
class invariants::class invariants
functions creating::functions creating
creating iterators::creating iterators
efficient looping::efficient looping
docs.python.org retrieved::docs.python.org retrieved
python cookbook::python cookbook
powerful force::powerful force
idiomatic python::idiomatic python
good language::good language
beginning programmers::beginning programmers
secnetix.de retrieved::secnetix.de retrieved
computer games::computer games
tail recursion::tail recursion
recursion elimination::recursion elimination
neopythonic.blogspot.be retrieved::neopythonic.blogspot.be retrieved
solving puzzles::solving puzzles
artima forums::artima forums
forums artima::forums artima
enhanced generators::enhanced generators
python.org retrieved::python.org retrieved
method definitions::method definitions
history faq::history faq
classic classes::classic classes
long integers::long integers
dedicated infix::dedicated infix
infix operator::infix operator
matrix multiplication::matrix multiplication
python.org jump::python.org jump
division operator::division operator
division floors::division floors
python standard::python standard
essential reference::essential reference
beazley jump::beazley jump
rapid web::rapid web
web development::web development
development environment::development environment
python server::python server
server pages::server pages
oracle technology::oracle technology
technology network::technology network
network oracle::network oracle
oracle retrieved::oracle retrieved
decimal data::decimal data
data type::data type
python web::python web
style guide::style guide
cpython byte::cpython byte
oreilly.com retrieved::oreilly.com retrieved
pypy compatibility::pypy compatibility
pypy.org retrieved::pypy.org retrieved
speed comparison::speed comparison
speed.pypy.org retrieved::speed.pypy.org retrieved
application-level stackless::application-level stackless
stackless features::stackless features
doc.pypy.org retrieved::doc.pypy.org retrieved
optimizing python::optimizing python
google project::google project
project hosting::project hosting
hosting google::hosting google
stochastic geometry::stochastic geometry
geometry jump::geometry jump
python runtimes::python runtimes
non-numeric scientific::non-numeric scientific
scientific code::scientific code
european conference::european conference
pep purpose::pep purpose
python.org python::python.org python
python developer::python developer
release schedules::release schedules
bug fix::bug fix
fix releases::fix releases
python buildbot::python buildbot
guide python::guide python
documentation docs.python.org::documentation docs.python.org
stack overflow::stack overflow
overflow stack::overflow stack
stack exchange::stack exchange
empirical comparison::empirical comparison
lutz prechelt::lutz prechelt
prechelt retrieved::prechelt retrieved
cern bulletin::cern bulletin
cern publications::cern publications
python streamlines::python streamlines
streamlines space::streamlines space
space shuttle::space shuttle
shuttle mission::shuttle mission
mission design::mission design
industrial light::industrial light
magic runs::magic runs
python slithers::python slithers
eweek.com ziff::eweek.com ziff
ziff davis::ziff davis
davis holdings::davis holdings
holdings retrieved::holdings retrieved
usage statistics::usage statistics
market share::market share
engineering jump::engineering jump
asked questions::asked questions
jasc psp9components::jasc psp9components
dead link::dead link
writing geoprocessing::writing geoprocessing
geoprocessing scripts::geoprocessing scripts
arcgis desktop::arcgis desktop
environmental systems::environmental systems
systems research::systems research
research institute::research institute
eve community::eve community
community dev::community dev
dev blogs::dev blogs
blogs ccp::blogs ccp
ccp games::ccp games
python jump::python jump
sid meier::sid meier
developer blog::developer blog
blog firaxis::blog firaxis
firaxis games::firaxis games
games archived::games archived
level offers::level offers
offers python::offers python
xml support::xml support
letting modders::letting modders
experience manipulate::experience manipulate
game world::game world
language guide::language guide
google documents::google documents
documents list::documents list
list data::list data
data api::data api
api v1.0::api v1.0
v1.0 google::v1.0 google
google archived::google archived
expert newsletter::expert newsletter
pypi.python.org retrieved::pypi.python.org retrieved
modern approach::modern approach
upper saddle::upper saddle
saddle river::saddle river
prentice hall::prentice hall
language toolkit::language toolkit
re secure::re secure
labs retrieved::labs retrieved
document foundation::document foundation
python users::python users
boo.codehaus.org codehaus::boo.codehaus.org codehaus
codehaus foundation::codehaus foundation
cobra-language.com cobra::cobra-language.com cobra
cobra language::cobra language
language retrieved::language retrieved
es4 wiki::es4 wiki
wiki.ecmascript.org retrieved::wiki.ecmascript.org retrieved
python meets::python meets
techcrunch retrieved::techcrunch retrieved
massachusetts institute::massachusetts institute
technology retrieved::technology retrieved
linuxdevcenter.com retrieved::linuxdevcenter.com retrieved
started work::started work
swift programming::swift programming
basic language::basic language
language structure::language structure
people knowing::people knowing
people started::people started
earnest late::earnest late
major focus::major focus
apple developer::apple developer
developer tools::developer tools
tools group::tools group
list jump::list jump
tip format::tip format
tcl.tk tcl::tcl.tk tcl
tcl developer::tcl developer
developer xchange::developer xchange
xchange retrieved::xchange retrieved
eep purpose::eep purpose
erlang.org retrieved::erlang.org retrieved
software march::software march
computer scientist::computer scientist
computerworld retrieved::computerworld retrieved
learning python::learning python
oreilly media::oreilly media
media isbn::media isbn
python apress::python apress
apress isbn::apress isbn
addison-wesley professional::addison-wesley professional
professional isbn::professional isbn
sister projects::sister projects
projects search::projects search
search commons::search commons
commons media::commons media
commons search::commons search
search wikiquote::search wikiquote
wikiquote quotations::wikiquote quotations
wikiquote search::wikiquote search
search wikibooks::search wikibooks
wikibooks textbooks::wikibooks textbooks
wikibooks search::wikibooks search
search wikiversity::search wikiversity
wikiversity learning::wikiversity learning
learning resources::learning resources
wikiversity official::wikiversity official
official website::official website
website python::website python
free web::free web
web access::web access
google groups::google groups
python development::python development
development list::development list
list python::list python
software categories::software categories
class-based programming::class-based programming
programming languagescross-platform::programming languagescross-platform
free softwaredutch::free softwaredutch
languageshigh-level programming::languageshigh-level programming
languagesobject-oriented programming::languagesobject-oriented programming
programming languagesprogramming::programming languagesprogramming
languagesprogramming languages::languagesprogramming languages
languages created::languages created
languagestext-oriented programming::languagestext-oriented programming
languages navigation::languages navigation
navigation menu::navigation menu
menu create::menu create
create accountlog::create accountlog
accountlog inarticletalkreadeditview::accountlog inarticletalkreadeditview
inarticletalkreadeditview history::inarticletalkreadeditview history
history main::history main
main page::main page
page contents::page contents
contents featured::contents featured
featured content::featured content
current events::current events
events random::events random
random article::random article
article donate::article donate
wikipedia wikipedia::wikipedia wikipedia
store interaction::store interaction
wikipedia community::wikipedia community
community portal::community portal
contact page::contact page
page tools::page tools
file special::file special
special pages::special pages
pages permanent::pages permanent
permanent link::permanent link
link page::link page
page information::page information
information wikidata::information wikidata
wikidata item::wikidata item
item cite::item cite
book download::book download
printable version::printable version
version languages::version languages
languages afrikaans::languages afrikaans
afrikaans alemannisch::afrikaans alemannisch
alemannisch aragon::alemannisch aragon
bosanski catal::bosanski catal
tina dansk::tina dansk
dansk deutsch::dansk deutsch
deutsch eesti::deutsch eesti
eesti espa::eesti espa
esperanto euskara::esperanto euskara
euskara fran::euskara fran
ais galego::ais galego
galego hrvatski::galego hrvatski
hrvatski bahasa::hrvatski bahasa
bahasa indonesia::bahasa indonesia
indonesia interlingua::indonesia interlingua
slenska italiano::slenska italiano
italiano latina::italiano latina
latina latvie::latina latvie
lietuvi lojban::lietuvi lojban
lojban magyar::lojban magyar
magyar bahasa::magyar bahasa
bahasa melayu::bahasa melayu
melayu nederlands::melayu nederlands
nederlands norsk::nederlands norsk
norsk bokm::norsk bokm
tsch polski::tsch polski
polski portugu::polski portugu
shqip simple::shqip simple
simple english::simple english
sloven ina::sloven ina
srpski srpskohrvatski::srpski srpskohrvatski
suomi svenska::suomi svenska
svenska tagalog::svenska tagalog
edit links::edit links
creative commons::creative commons
attribution-sharealike license::attribution-sharealike license
additional terms::additional terms
privacy policy::privacy policy
policy wikipedia::policy wikipedia
registered trademark::registered trademark
wikimedia foundation::wikimedia foundation
non-profit organization::non-profit organization
organization privacy::organization privacy
policyabout wikipediadisclaimerscontact::policyabout wikipediadisclaimerscontact
wikipediadisclaimerscontact wikipediadevelopersmobile::wikipediadisclaimerscontact wikipediadevelopersmobile
wikipediadevelopersmobile viewwikimedia::wikipediadevelopersmobile viewwikimedia
viewwikimedia foundation::viewwikimedia foundation
foundation powered::foundation powered
good::good
article::article
click::click
information::information
python::python
programming::programming
language::language
wikipedia::wikipedia
free::free
encyclopedia::encyclopedia
logo::logo
wordmark.svg::wordmark.svg
paradigm::paradigm
multi-paradigm::multi-paradigm
object-oriented::object-oriented
imperative::imperative
functional::functional
procedural::procedural
reflective::reflective
designed::designed
guido::guido
van::van
rossum::rossum
developer::developer
software::software
foundation::foundation
first::first
appeared::appeared
years::years
ago::ago
stable::stable
release::release
3.4.3::3.4.3
february::february
2.7.10::2.7.10
preview::preview
3.5.0b3::3.5.0b3
july::july
typing::typing
discipline::discipline
duck::duck
dynamic::dynamic
strong::strong
gradual::gradual
cross-platform::cross-platform
license::license
filename::filename
extensions::extensions
.py::.py
.pyc::.pyc
.pyd::.pyd
.pyo::.pyo
.pyw::.pyw
website::website
www.python.org::www.python.org
major::major
implementations::implementations
cpython::cpython
ironpython::ironpython
jython::jython
pypy::pypy
dialects::dialects
cython::cython
rpython::rpython
stackless::stackless
influenced::influenced
abc::abc
algol::algol
dylan::dylan
haskell::haskell
icon::icon
java::java
lisp::lisp
modula-3::modula-3
perl::perl
boo::boo
cobra::cobra
falcon::falcon
groovy::groovy
javascript::javascript
julia::julia
nim::nim
ruby::ruby
swift::swift
wikibooks::wikibooks
widely::widely
general-purpose::general-purpose
high-level::high-level
design::design
philosophy::philosophy
emphasizes::emphasizes
code::code
readability::readability
syntax::syntax
programmers::programmers
express::express
concepts::concepts
fewer::fewer
lines::lines
languages::languages
constructs::constructs
intended::intended
enable::enable
clear::clear
programs::programs
small::small
large::large
scale::scale
supports::supports
multiple::multiple
paradigms::paradigms
including::including
styles::styles
features::features
type::type
system::system
automatic::automatic
memory::memory
management::management
comprehensive::comprehensive
standard::standard
library::library
interpreters::interpreters
installation::installation
operating::operating
systems::systems
allowing::allowing
execution::execution
wide::wide
variety::variety
third-party::third-party
tools::tools
py2exe::py2exe
pyinstaller::pyinstaller
packaged::packaged
stand-alone::stand-alone
executable::executable
popular::popular
distribution::distribution
python-based::python-based
environments::environments
requiring::requiring
interpreter::interpreter
reference::reference
implementation::implementation
open-source::open-source
community-based::community-based
development::development
model::model
alternative::alternative
managed::managed
non-profit::non-profit
contents::contents
hide::hide
history::history
semantics::semantics
indentation::indentation
statements::statements
control::control
flow::flow
expressions::expressions
methods::methods
mathematics::mathematics
libraries::libraries
naming::naming
references::references
reading::reading
external::external
links::links
edit::edit
creator::creator
main::main
conceived::conceived
late::late
1980s::1980s
started::started
december::december
cwi::cwi
netherlands::netherlands
successor::successor
inspired::inspired
setl::setl
capable::capable
exception::exception
handling::handling
interfacing::interfacing
amoeba::amoeba
principal::principal
author::author
continuing::continuing
central::central
role::role
deciding::deciding
direction::direction
reflected::reflected
title::title
community::community
benevolent::benevolent
dictator::dictator
life::life
bdfl::bdfl
origin::origin
wrote::wrote
hobby::hobby
project::project
occupied::occupied
week::week
christmas::christmas
office::office
closed::closed
home::home
computer::computer
hands::hands
decided::decided
write::write
scripting::scripting
thinking::thinking
descendant::descendant
appeal::appeal
hackers::hackers
chose::chose
working::working
slightly::slightly
irreverent::irreverent
mood::mood
big::big
fan::fan
monty::monty
flying::flying
circus::circus
released::released
october::october
included::included
full::full
garbage::garbage
collector::collector
support::support
unicode::unicode
process::process
changed::changed
transparent::transparent
community-backed::community-backed
py3k::py3k
backwards-incompatible::backwards-incompatible
long::long
period::period
testing::testing
backported::backported
backwards-compatible::backwards-compatible
structured::structured
fully::fully
supported::supported
number::number
aspect-oriented::aspect-oriented
metaprogramming::metaprogramming
magic::magic
contract::contract
logic::logic
combination::combination
counting::counting
cycle-detecting::cycle-detecting
important::important
feature::feature
resolution::resolution
binding::binding
binds::binds
method::method
variable::variable
names::names
program::program
offers::offers
tradition::tradition
map::map
reduce::reduce
filter::filter
functions::functions
comprehensions::comprehensions
lists::lists
dictionaries::dictionaries
sets::sets
generator::generator
two::two
modules::modules
itertools::itertools
functools::functools
implement::implement
borrowed::borrowed
core::core
summarized::summarized
document::document
pep::pep
zen::zen
includes::includes
aphorisms::aphorisms
beautiful::beautiful
ugly::ugly
explicit::explicit
implicit::implicit
simple::simple
complex::complex
complicated::complicated
counts::counts
desired::desired
functionality::functionality
built::built
highly::highly
extensible::extensible
embedded::embedded
existing::existing
applications::applications
programmable::programmable
interface::interface
easily::easily
start::start
frustrations::frustrations
espoused::espoused
opposite::opposite
mindset::mindset
offering::offering
choice::choice
coding::coding
methodology::methodology
rejects::rejects
exuberant::exuberant
favor::favor
sparser::sparser
less-cluttered::less-cluttered
grammar::grammar
alex::alex
martelli::martelli
put::put
describe::describe
clever::clever
considered::considered
compliment::compliment
culture::culture
approach::approach
preferably::preferably
obvious::obvious
developers::developers
strive::strive
avoid::avoid
premature::premature
optimization::optimization
reject::reject
patches::patches
non-critical::non-critical
parts::parts
offer::offer
marginal::marginal
increase::increase
speed::speed
cost::cost
clarity::clarity
just-in-time::just-in-time
compiler::compiler
move::move
time-critical::time-critical
extension::extension
written::written
translates::translates
script::script
makes::makes
direct::direct
level::level
api::api
calls::calls
goal::goal
making::making
fun::fun
occasionally::occasionally
playful::playful
tutorials::tutorials
materials::materials
examples::examples
spam::spam
eggs::eggs
foo::foo
bar::bar
common::common
neologism::neologism
pythonic::pythonic
range::range
meanings::meanings
related::related
style::style
idioms::idioms
natural::natural
shows::shows
fluency::fluency
conforms::conforms
minimalist::minimalist
emphasis::emphasis
contrast::contrast
difficult::difficult
understand::understand
reads::reads
rough::rough
transcription::transcription
unpythonic::unpythonic
users::users
admirers::admirers
knowledgeable::knowledgeable
experienced::experienced
referred::referred
pythonists::pythonists
pythonistas::pythonistas
pythoneers::pythoneers
readable::readable
uncluttered::uncluttered
visual::visual
layout::layout
frequently::frequently
english::english
keywords::keywords
punctuation::punctuation
smaller::smaller
syntactic::syntactic
exceptions::exceptions
special::special
cases::cases
pascal::pascal
whitespace::whitespace
curly::curly
braces::braces
delimit::delimit
blocks::blocks
termed::termed
off-side::off-side
rule::rule
decrease::decrease
signifies::signifies
end::end
current::current
block::block
include::include
statement::statement
conditionally::conditionally
executes::executes
elif::elif
contraction::contraction
else-if::else-if
iterates::iterates
iterable::iterable
object::object
capturing::capturing
element::element
local::local
attached::attached
condition::condition
true::true
raised::raised
caught::caught
handled::handled
clauses::clauses
ensures::ensures
clean-up::clean-up
finally::finally
run::run
exits::exits
class::class
attaches::attaches
namespace::namespace
def::def
defines::defines
function::function
encloses::encloses
context::context
manager::manager
acquiring::acquiring
lock::lock
releasing::releasing
opening::opening
file::file
closing::closing
raii-like::raii-like
behavior::behavior
pass::pass
serves::serves
nop::nop
syntactically::syntactically
needed::needed
create::create
empty::empty
assert::assert
debugging::debugging
check::check
conditions::conditions
apply::apply
yield::yield
returns::returns
value::value
operator::operator
form::form
coroutines::coroutines
import::import
variables::variables
print::print
tail-call::tail-call
first-class::first-class
continuations::continuations
coroutine-like::coroutine-like
provided::provided
extending::extending
generators::generators
prior::prior
lazy::lazy
iterators::iterators
passed::passed
unidirectionally::unidirectionally
out::out
back::back
stack::stack
levels::levels
similar::similar
addition::addition
subtraction::subtraction
multiplication::multiplication
division::division
differs::differs
details::details
added::added
exponentiation::exponentiation
compares::compares
comparisons::comparisons
equals::equals
compare::compare
identities::identities
comparison::comparison
chained::chained
words::words
boolean::boolean
operators::operators
symbolic::symbolic
expression::expression
list::list
comprehension::comprehension
extended::extended
general::general
anonymous::anonymous
implemented::implemented
lambda::lambda
limited::limited
body::body
single::single
conditional::conditional
order::order
operands::operands
distinction::distinction
tuples::tuples
mutable::mutable
keys::keys
dictionary::dictionary
immutable::immutable
elements::elements
tuple::tuple
parentheses::parentheses
optional::optional
contexts::contexts
left::left
side::side
equal::equal
sign::sign
swap::swap
string::string
format::format
analogous::analogous
printf::printf
strings::strings
e.g::e.g
blah::blah
evaluates::evaluates
supplemented::supplemented
str::str
.format::.format
kinds::kinds
literals::literals
delimited::delimited
double::double
quotation::quotation
marks::marks
unlike::unlike
unix::unix
shells::shells
perl-influenced::perl-influenced
identically::identically
backslash::backslash
escape::escape
character::character
interpolation::interpolation
triple-quoted::triple-quoted
begin::begin
series::series
span::span
documents::documents
raw::raw
varieties::varieties
denoted::denoted
prefixing::prefixing
literal::literal
sequences::sequences
interpreted::interpreted
backslashes::backslashes
regular::regular
windows-style::windows-style
paths::paths
-quoting::-quoting
index::index
slice::slice
key::key
stop::stop
step::step
indexes::indexes
zero-based::zero-based
negative::negative
relative::relative
slices::slices
parameter::parameter
stride::stride
skipped::skipped
reversed::reversed
omitted::omitted
copy::copy
entire::entire
shallow::shallow
rigidly::rigidly
enforced::enforced
scheme::scheme
leads::leads
duplication::duplication
for-loops::for-loops
eval::eval
exec::exec
built-in::built-in
part::part
case::case
assignment::assignment
advantage::advantage
avoiding::avoiding
classic::classic
error::error
mistaking::mistaking
equality::equality
valid::valid
objects::objects
instance.method::instance.method
argument::argument
normal::normal
sugar::sugar
class.method::class.method
instance::instance
access::access
data::data
objective-c::objective-c
typed::typed
untyped::untyped
constraints::constraints
checked::checked
compile::compile
operations::operations
fail::fail
signifying::signifying
suitable::suitable
dynamically::dynamically
strongly::strongly
forbidding::forbidding
well-defined::well-defined
adding::adding
silently::silently
attempting::attempting
make::make
sense::sense
define::define
types::types
classes::classes
instances::instances
constructed::constructed
calling::calling
spamclass::spamclass
eggsclass::eggsclass
metaclass::metaclass
reflection::reflection
version::version
old-style::old-style
new-style::new-style
eliminated::eliminated
versions::versions
difference::difference
inherited::inherited
directly::directly
indirectly::indirectly
inherit::inherit
summary::summary
description::description
sequence::sequence
codepoints::codepoints
wikipedia::wikipedia
spanning::spanning
bytearray::bytearray
bytes::bytes
bsome::bsome
ascii::ascii
mixed::mixed
string::string
set::set
frozenset::frozenset
unordered::unordered
duplicates::duplicates
hashable::hashable
dict::dict
associative::associative
array::array
pairs::pairs
values::values
key1::key1
false::false
int::int
integer::integer
unlimited::unlimited
magnitude::magnitude
float::float
floating::floating
point::point
system-defined::system-defined
precision::precision
real::real
imaginary::imaginary
2.7j::2.7j
bool::bool
ellipsis::ellipsis
placeholder::placeholder
numpy::numpy
arrays::arrays
usual::usual
arithmetic::arithmetic
matrix::matrix
multiply::multiply
coming::coming
significantly::significantly
earlier::earlier
integers::integers
rounds::rounds
round::round
floor::floor
introduced::introduced
__future__::__future__
module::module
rules::rules
terms::terms
pre-3.0::pre-3.0
rounding::rounding
adds::adds
consistency::consistency
means::means
equation::equation
positive::positive
maintaining::maintaining
validity::validity
result::result
expected::expected
half-open::half-open
interval::interval
0,b::0,b
lie::lie
b,0::b,0
floats::floats
round-away-from-zero::round-away-from-zero
round-to-even::round-to-even
decimal::decimal
exact::exact
numerical::numerical
representation::representation
modes::modes
relations::relations
manner::manner
consistent::consistent
usage::usage
tests::tests
c-derived::c-derived
interpret::interpret
differently::differently
evaluate::evaluate
resulting::resulting
compared::compared
page::page
due::due
extensive::extensive
scientific::scientific
aid::aid
problems::problems
processing::processing
manipulation::manipulation
commonly::commonly
cited::cited
greatest::greatest
strengths::strengths
providing::providing
suited::suited
tasks::tasks
deliberate::deliberate
described::described
batteries::batteries
internet-facing::internet-facing
formats::formats
protocols::protocols
mime::mime
http::http
creating::creating
graphical::graphical
user::user
interfaces::interfaces
connecting::connecting
relational::relational
databases::databases
pseudorandom::pseudorandom
arbitrary::arbitrary
decimals::decimals
manipulating::manipulating
doing::doing
unit::unit
covered::covered
specifications::specifications
wsgi::wsgi
wsgiref::wsgiref
majority::majority
internal::internal
documentation::documentation
test::test
suite::suite
supplied::supplied
altered::altered
completely::completely
rewritten::rewritten
essential::essential
embed::embed
application::application
blender::blender
omits::omits
january::january
package::package
official::official
repository::repository
54,000::54,000
packages::packages
web::web
frameworks::frameworks
multimedia::multimedia
networking::networking
communications::communications
automation::automation
scraping::scraping
administration::administration
computing::computing
text::text
image::image
integrated::integrated
command::command
line::line
enters::enters
sequentially::sequentially
receives::receives
results::results
immediately::immediately
repl::repl
short::short
acts::acts
shell::shell
add::add
capabilities::capabilities
basic::basic
idle::idle
ipython::ipython
generally::generally
auto-completion::auto-completion
retention::retention
session::session
state::state
highlighting::highlighting
desktop::desktop
ides::ides
browser-based::browser-based
sage::sage
developing::developing
science::science
math-related::math-related
ide::ide
hosting::hosting
environment::environment
pythonanywhere::pythonanywhere
named::named
meeting::meeting
c89::c89
compiles::compiles
intermediate::intermediate
bytecode::bytecode
executed::executed
virtual::virtual
machine::machine
distributed::distributed
mixture::mixture
platforms::platforms
microsoft::microsoft
windows::windows
modern::modern
unix-like::unix-like
conception::conception
fast::fast
compliant::compliant
brings::brings
significant::significant
improvement::improvement
taking::taking
multi-core::multi-core
processors::processors
transactional::transactional
created::created
fork::fork
implements::implements
microthreads::microthreads
massively::massively
concurrent::concurrent
compilers::compilers
developed::developed
past::past
unsupported::unsupported
google::google
unladen::unladen
swallow::swallow
aims::aims
increasing::increasing
times::times
llvm::llvm
improving::improving
multithreading::multithreading
ability::ability
thousands::thousands
cores::cores
psyco::psyco
specialising::specialising
integrates::integrates
transforms::transforms
runtime::runtime
produced::produced
specialised::specialised
faster::faster
nokia::nokia
mobile::mobile
phones::phones
pys60::pys60
additional::additional
integration::integration
symbian::symbian
date::date
variants::variants
s60::s60
platform::platform
party::party
n900::n900
gtk::gtk
widget::widget
device::device
unrestricted::unrestricted
restricted::restricted
subset::subset
source::source
byte::byte
enables::enables
.net::.net
compiled::compiled
build::build
pyjamas::pyjamas
shed::shed
skin::skin
pyrex::pyrex
performance::performance
non-numerical::non-numerical
combinatorial::combinatorial
workload::workload
presented::presented
euroscipy::euroscipy
13::13
conducted::conducted
largely::largely
enhancement::enhancement
proposal::proposal
primary::primary
mechanism::mechanism
proposing::proposing
collecting::collecting
input::input
issue::issue
documenting::documenting
decisions::decisions
outstanding::outstanding
peps::peps
reviewed::reviewed
commented::commented
mailing::mailing
python-dev::python-dev
forum::forum
discussion::discussion
specific::specific
issues::issues
discussed::discussed
roundup::roundup
bug::bug
tracker::tracker
maintained::maintained
python.org::python.org
takes::takes
place::place
self-hosted::self-hosted
running::running
mercurial::mercurial
public::public
releases::releases
distinguished::distinguished
incremented::incremented
break::break
manually::manually
ported::ported
happen::happen
infrequently::infrequently
compatible::compatible
introduce::introduce
scheduled::scheduled
occur::occur
roughly::roughly
months::months
bugfixes::bugfixes
bugfix::bugfix
fix::fix
bugs::bugs
final::final
made::made
sufficient::sufficient
fixed::fixed
upstream::upstream
last::last
security::security
vulnerabilities::vulnerabilities
patched::patched
alpha::alpha
beta::beta
release-candidates::release-candidates
previews::previews
schedule::schedule
pushed::pushed
ready::ready
team::team
monitor::monitor
buildbot::buildbot
continuous::continuous
contributed::contributed
58,000::58,000
pypi::pypi
academic::academic
conference::conference
pycon::pycon
mentoring::mentoring
programmes::programmes
pyladies::pyladies
derived::derived
television::television
metasyntactic::metasyntactic
literature::literature
traditional::traditional
obscure::obscure
prefix::prefix
py::py-
show::show
pygame::pygame
sdl::sdl
games::games
pyqt::pyqt
pygtk::pygtk
bind::bind
originally::originally
consistently::consistently
ranked::ranked
top::top
measured::measured
tiobe::tiobe
grammatical::grammatical
predominantly::predominantly
based::based
empirical::empirical
study::study
found::found
productive::productive
conventional::conventional
problem::problem
involving::involving
search::search
consumption::consumption
worse::worse
organizations::organizations
yahoo::yahoo
cern::cern
nasa::nasa
ilm::ilm
ita::ita
serve::serve
mod_wsgi::mod_wsgi
apache::apache
server::server
gateway::gateway
evolved::evolved
facilitate::facilitate
django::django
pylons::pylons
pyramid::pyramid
turbogears::turbogears
web2py::web2py
tornado::tornado
flask::flask
zope::zope
maintenance::maintenance
develop::develop
client-side::client-side
ajax-based::ajax-based
sqlalchemy::sqlalchemy
mapper::mapper
database::database
twisted::twisted
framework::framework
computers::computers
dropbox::dropbox
scipy::scipy
matplotlib::matplotlib
effective::effective
specialized::specialized
biopython::biopython
astropy::astropy
domain-specific::domain-specific
mathematical::mathematical
notebook::notebook
covers::covers
aspects::aspects
algebra::algebra
combinatorics::combinatorics
theory::theory
calculus::calculus
successfully::successfully
products::products
finite::finite
abaqus::abaqus
parametric::parametric
modeler::modeler
freecad::freecad
animation::animation
3ds::3ds
max::max
cinema::cinema
lightwave::lightwave
houdini::houdini
maya::maya
modo::modo
motionbuilder::motionbuilder
softimage::softimage
effects::effects
compositor::compositor
nuke::nuke
imaging::imaging
gimp::gimp
inkscape::inkscape
scribus::scribus
paint::paint
shop::shop
pro::pro
musical::musical
notation::notation
scorewriter::scorewriter
capella::capella
gnu::gnu
debugger::debugger
pretty::pretty
printer::printer
structures::structures
containers::containers
esri::esri
promotes::promotes
writing::writing
scripts::scripts
arcgis::arcgis
video::video
adopted::adopted
app::app
engine::engine
artificial::artificial
intelligence::intelligence
architecture::architecture
rich::rich
component::component
ships::ships
linux::linux
distributions::distributions
amigaos::amigaos
freebsd::freebsd
netbsd::netbsd
openbsd::openbsd
terminal::terminal
installers::installers
ubuntu::ubuntu
ubiquity::ubiquity
installer::installer
red::red
hat::hat
fedora::fedora
anaconda::anaconda
gentoo::gentoo
portage::portage
industry::industry
exploit::exploit
laptop::laptop
child::child
labs::labs
raspberry::raspberry
single-board::single-board
user-programming::user-programming
libreoffice::libreoffice
intends::intends
replace::replace
provider::provider
static::static
closely::closely
acknowledgements::acknowledgements
design-by-contract::design-by-contract
ecmascript::ecmascript
incorporating::incorporating
motivated::motivated
desire::desire
bring::bring
ocaml::ocaml
twt::twt
thing::thing
yukihiro::yukihiro
matsumoto::matsumoto
wanted::wanted
powerful::powerful
coffeescript::coffeescript
cross-compiles::cross-compiles
invented::invented
apple::apple
practices::practices
emulated::emulated
practice::practice
describing::describing
rationale::rationale
surrounding::surrounding
change::change
tcl::tcl
erlang::erlang
influence::influence
awarded::awarded
year::year
award::award
growth::growth
popularity::popularity
portal::portal
expressed::expressed
lamp::lamp
bundle::bundle
leap::leap
jump::jump
retrieved::retrieved
hinting::hinting
lwn.net::lwn.net
2014-12-24::2014-12-24
2015-05-05::2015-05-05
faq::faq
march::march
kuchling::kuchling
andrew::andrew
interview::interview
amk.ca::amk.ca
introduction::introduction
proceedings::proceedings
nluug::nluug
najaarsconferentie::najaarsconferentie
dutch::dutch
group::group
ideal::ideal
considerable::considerable
tutorial::tutorial
mechanisms::mechanisms
simionato::simionato
michele::michele
people::people
paper::paper
lispers::lispers
howto::howto
v2.7.2::v2.7.2
schemenauer::schemenauer
neil::neil
peters::peters
tim::tim
hetland::hetland
magnus::magnus
proposals::proposals
smith::smith
kevin::kevin
jewett::jewett
jim::jim
montanaro::montanaro
skip::skip
baxter::baxter
anthony::anthony
september::september
decorators::decorators
august::august
influences::influences
www.2ality.com::www.2ality.com
rauschmayer::rauschmayer
axel::axel
chapter::chapter
tha::tha
nature::nature
oreilly::oreilly
speaking::speaking
june::june
bini::bini
ola::ola
practical::practical
jruby::jruby
rails::rails
projects::projects
bringing::bringing
berkeley::berkeley
apress::apress
isbn::isbn
978-1-59059-881-8::978-1-59059-881-8
lattner::lattner
chris::chris
homepage::homepage
product::product
tireless::tireless
effort::effort
experts::experts
gurus::gurus
ninjas::ninjas
incredibly::incredibly
dogfooding::dogfooding
feedback::feedback
refine::refine
battle-test::battle-test
ideas::ideas
greatly::greatly
benefited::benefited
experiences::experiences
hard-won::hard-won
field::field
drawing::drawing
rust::rust
clu::clu
trends::trends
radar::radar
radar.oreilly.com::radar.oreilly.com
redmonk::redmonk
rankings::rankings
tecosystems::tecosystems
redmonk.com::redmonk.com
summerfield::summerfield
mark::mark
rapid::rapid
gui::gui
expressive::expressive
required::required
equivalent::equivalent
mcconnell::mcconnell
steve::steve
november::november
complete::complete
kuhlman::kuhlman
dave::dave
book::book
beginning::beginning
advanced::advanced
exercises::exercises
april::april
section::section
fans::fans
phrase::phrase
asynchronous::asynchronous
zip::zip
files::files
venners::venners
bill::bill
artima::artima
timeline::timeline
lukewarm::lukewarm
foreword::foreword
1st::1st
zadka::zadka
moshe::moshe
cain::cain
gang::gang
metaclasses::metaclasses
archived::archived
original::original
pdf::pdf
pydbc::pydbc
preconditions::preconditions
postconditions::postconditions
invariants::invariants
contracts::contracts
pydatalog::pydatalog
hettinger::hettinger
raymond::raymond
efficient::efficient
looping::looping
docs.python.org::docs.python.org
cookbook::cookbook
2nd::2nd
ways::ways
force::force
pprint::pprint
goodger::goodger
david::david
pythonista::pythonista
idiomatic::idiomatic
myths::myths
secnetix.de::secnetix.de
sweigart::sweigart
appendix::appendix
differences::differences
invent::invent
978-0-9821060-1-3::978-0-9821060-1-3
tail::tail
recursion::recursion
elimination::elimination
neopythonic.blogspot.be::neopythonic.blogspot.be
solving::solving
puzzles::puzzles
forums::forums
eby::eby
phillip::phillip
enhanced::enhanced
self::self
explicitly::explicitly
definitions::definitions
2.7.1::2.7.1
unifying::unifying
dedicated::dedicated
infix::infix
changing::changing
floors::floors
beazley::beazley
piotrowski::piotrowski
przemyslaw::przemyslaw
pages::pages
oracle::oracle
technology::technology
network::network
batista::batista
facundo::facundo
v1.0::v1.0
guide::guide
internals::internals
oreilly.com::oreilly.com
compatibility::compatibility
pypy.org::pypy.org
speed.pypy.org::speed.pypy.org
stm::stm
threads::threads
morepypy.blogspot.be::morepypy.blogspot.be
application-level::application-level
2.0.2::2.0.2
doc.pypy.org::doc.pypy.org
plans::plans
optimizing::optimizing
stochastic::stochastic
geometry::geometry
murri::murri
riccardo::riccardo
runtimes::runtimes
non-numeric::non-numeric
european::european
warsaw::warsaw
barry::barry
hylton::hylton
jeremy::jeremy
purpose::purpose
guidelines::guidelines
cannon::cannon
brett::brett
guys::guys
norwitz::norwitz
neal::neal
schedules::schedules
stability::stability
aahz::aahz
v2.7.3::v2.7.3
whetting::whetting
appetite::appetite
return::return
overflow::overflow
exchange::exchange
prechelt::prechelt
lutz::lutz
rexx::rexx
bibliography::bibliography
quotes::quotes
holy::holy
grail::grail
bulletin::bulletin
publications::publications
shafer::shafer
daniel::daniel
streamlines::streamlines
space::space
shuttle::shuttle
mission::mission
fortenberry::fortenberry
industrial::industrial
light::light
runs::runs
taft::taft
darryl::darryl
slithers::slithers
eweek.com::eweek.com
ziff::ziff
davis::davis
holdings::holdings
statistics::statistics
market::market
share::share
websites::websites
oliphant::oliphant
travis::travis
engineering::engineering
millman::millman
jarrod::jarrod
aivazis::aivazis
michael::michael
scientists::scientists
engineers::engineers
asked::asked
questions::questions
jasc::jasc
psp9components::psp9components
dead::dead
link::link
geoprocessing::geoprocessing
environmental::environmental
research::research
institute::institute
ccp::ccp
porkbelly::porkbelly
eve::eve
dev::dev
blogs::blogs
caudill::caudill
modding::modding
sid::sid
meier::meier
civilization::civilization
blog::blog
firaxis::firaxis
xml::xml
letting::letting
modders::modders
experience::experience
manipulate::manipulate
game::game
world::world
wiki.python.org::wiki.python.org
paine::paine
jocelyn::jocelyn
expert::expert
newsletter::newsletter
amzi::amzi
pyaiml::pyaiml
0.8.5::0.8.5
pypi.python.org::pypi.python.org
russell::russell
stuart::stuart
norvig::norvig
peter::peter
3rd::3rd
upper::upper
saddle::saddle
river::river
prentice::prentice
hall::hall
978-0-13-604259-4::978-0-13-604259-4
toolkit::toolkit
immunity::immunity
knowing::knowing
re::re
secure::secure
corelabs::corelabs
site::site
fixes::fixes
libreoffice.org::libreoffice.org
gotchas::gotchas
boo.codehaus.org::boo.codehaus.org
codehaus::codehaus
esterbrook::esterbrook
charles::charles
cobra-language.com::cobra-language.com
es4::es4
wiki::wiki
wiki.ecmascript.org::wiki.ecmascript.org
kincaid::kincaid
jason::jason
meets::meets
techcrunch::techcrunch
strachan::strachan
james::james
birth::birth
lin::lin
mike::mike
massachusetts::massachusetts
linuxdevcenter.com::linuxdevcenter.com
work::work
structure::structure
existence::existence
amazing::amazing
contributing::contributing
earnest::earnest
focus::focus
kupries::kupries
andreas::andreas
fellows::fellows
donal::donal
tip::tip
tcl.tk::tcl.tk
xchange::xchange
gustafsson::gustafsson
niskanen::niskanen
raimo::raimo
eep::eep
erlang.org::erlang.org
downey::downey
allen::allen
scientist::scientist
1.6.6::1.6.6
978-0-521-72596-5::978-0-521-72596-5
hamilton::hamilton
naomi::naomi
a-z::a-z
computerworld::computerworld
learning::learning
5th::5th
media::media
978-0-596-15806-4::978-0-596-15806-4
pilgrim::pilgrim
dive::dive
978-1-59059-356-1::978-1-59059-356-1
978-1-4302-2415-0::978-1-4302-2415-0
addison-wesley::addison-wesley
professional::professional
978-0-321-68056-3::978-0-321-68056-3
find::find
sister::sister
commons::commons
wikiquote::wikiquote
quotations::quotations
textbooks::textbooks
wikiversity::wikiversity
resources::resources
newsgroup::newsgroup
usenet::usenet
groups::groups
dmoz::dmoz
categories::categories
class-based::class-based
languagescross-platform::languagescross-platform
softwaredutch::softwaredutch
inventionsdynamically::inventionsdynamically
languageshigh-level::languageshigh-level
languagesobject-oriented::languagesobject-oriented
languagesprogramming::languagesprogramming
1991python::1991python
languagestext-oriented::languagestext-oriented
navigation::navigation
menu::menu
accountlog::accountlog
inarticletalkreadeditview::inarticletalkreadeditview
featured::featured
content::content
events::events
random::random
donate::donate
store::store
interaction::interaction
recent::recent
contact::contact
upload::upload
permanent::permanent
wikidata::wikidata
item::item
cite::cite
download::download
printable::printable
afrikaans::afrikaans
alemannisch::alemannisch
aragon::aragon
rbaycanca::rbaycanca
n-l::n-l
m-g::m-g
bosanski::bosanski
catal::catal
cebuano::cebuano
tina::tina
dansk::dansk
deutsch::deutsch
eesti::eesti
espa::espa
esperanto::esperanto
euskara::euskara
fran::fran
ais::ais
galego::galego
hrvatski::hrvatski
bahasa::bahasa
indonesia::indonesia
interlingua::interlingua
slenska::slenska
italiano::italiano
latina::latina
latvie::latvie
lietuvi::lietuvi
lojban::lojban
magyar::magyar
melayu::melayu
nederlands::nederlands
norsk::norsk
bokm::bokm
plattd::plattd
tsch::tsch
polski::polski
portugu::portugu
rom::rom
shqip::shqip
sloven::sloven
ina::ina
srpski::srpski
srpskohrvatski::srpskohrvatski
suomi::suomi
svenska::svenska
tagalog::tagalog
modified::modified
creative::creative
attribution-sharealike::attribution-sharealike
agree::agree
privacy::privacy
policy::policy
registered::registered
trademark::trademark
wikimedia::wikimedia
organization::organization
policyabout::policyabout
wikipediadisclaimerscontact::wikipediadisclaimerscontact
wikipediadevelopersmobile::wikipediadevelopersmobile
viewwikimedia::viewwikimedia
powered::powered
