introduction to computer::introduction to computer
computer programming summer::computer programming summer
administration office hours::administration office hours
office hours held::office hours held
posted on announcements::posted on announcements
people in thursday::people in thursday
tutorials consider switching::tutorials consider switching
class in ba1170::class in ba1170
ba1170 on june::ba1170 on june
july 14th website::july 14th website
14th website typo::14th website typo
typo in info::typo in info
added my e-mail::added my e-mail
e-mail is quellan::e-mail is quellan
quellan @ cs.toronto.edu::quellan @ cs.toronto.edu
cs.toronto.edu not quellan::cs.toronto.edu not quellan
short and simple::short and simple
machines no questions::machines no questions
accepted after june::accepted after june
programs to recipes::programs to recipes
programs can behave::programs can behave
behave differently depending::behave differently depending
two values true::two values true
false and vice::false and vice
versa and returns::versa and returns
arguments are true::arguments are true
true or returns::true or returns
arguments are false::arguments are false
representing boolean expressions::representing boolean expressions
true true false::true true false
true false false::true false false
false false true::false false true
false true true::false true true
true true true::true true true
false true false::false true false
true false true::true false true
adapatively assign boolean::adapatively assign boolean
assign boolean values::assign boolean values
operators that return::operators that return
true or false::true or false
expressions and representation::expressions and representation
representation can combine::representation can combine
combine boolean operators::combine boolean operators
legal expression arithmetic::legal expression arithmetic
false is represented::false is represented
true is represented::true is represented
lead to weirdness::lead to weirdness
short circuit evaluation::short circuit evaluation
circuit evaluation python::circuit evaluation python
python only evaluates::python only evaluates
evaluates a boolean::evaluates a boolean
answer is clear::answer is clear
nature of boolean::nature of boolean
representation can lead::representation can lead
lead to strange::lead to strange
strange behaviour exploiting::strange behaviour exploiting
exploiting these behaviours::exploiting these behaviours
behaviours is bad::behaviours is bad
boolean variables recall::boolean variables recall
make our code::make our code
selectively execute blocks::selectively execute blocks
blocks of code::blocks of code
statement the general::statement the general
print “ pass::print “ pass
block the condition::block the condition
boolean expression recall::boolean expression recall
series of python::series of python
evaluates to true::evaluates to true
true the block::true the block
block is executed::block is executed
execute different lines::execute different lines
lines of code::lines of code
block the block::block the block
evaluates to false::evaluates to false
general if statement::general if statement
statement if condition1::statement if condition1
block elif condition2::block elif condition2
block elif condition3::block elif condition3
block python evalutates::block python evalutates
evalutates the conditions::evalutates the conditions
conditions in order::conditions in order
order it executes::order it executes
executes the block::executes the block
true the final::true the final
advice for booleans::advice for booleans
unsure of precedence::unsure of precedence
parentheses will make::parentheses will make
make it easier::make it easier
parentheses for complicated::parentheses for complicated
complicated expressions simplify::complicated expressions simplify
simplify your boolean::simplify your boolean
expressions get rid::expressions get rid
rid of double::rid of double
review of functions::review of functions
functions we started::functions we started
python s native::python s native
bits of code::bits of code
updating and testing::updating and testing
testing much easier::testing much easier
test and update::test and update
update the function::update the function
return vs print::return vs print
recall that functions::recall that functions
return the value::return the value
print statement print::print statement print
statement print takes::statement print takes
multiple function calls::multiple function calls
calling other functions::calling other functions
out  rule::out  rule
apply g first::apply g first
python choose variables::python choose variables
python has local::python has local
local and global::local and global
global variables local::global variables local
variables local variables::variables local variables
variables are defined::variables are defined
inside of functions::inside of functions
check local variables::check local variables
local variables defined::local variables defined
function then check::function then check
check global variables::check global variables
check built-in variables::check built-in variables
variable is defined::variable is defined
call a function::call a function
create a local::create a local
functions name space::functions name space
space or global::space or global
conventions for functions::conventions for functions
initialise and call::initialise and call
call variables exploiting::call variables exploiting
style it makes::style it makes
hard to read::hard to read
read and prone::read and prone
prone to errors::prone to errors
rely on global::rely on global
functions that return::functions that return
information to code::information to code
code should return::code should return
function documentation recall::function documentation recall
information on functions::information on functions
functions or modules::functions or modules
give much information::give much information
add useful documentation::add useful documentation
documentation with docstrings::documentation with docstrings
docstrings a docstring::docstrings a docstring
docstring is surrounded::docstring is surrounded
module or function::module or function
function or module::function or module
short for documentation::short for documentation
documentation string python::documentation string python
string python saves::string python saves
saves the string::saves the string
string to return::string to return
leave a blank::leave a blank
docstring all functions::docstring all functions
write the docstring::write the docstring
instant sanity check::instant sanity check
function is doing::function is doing
portability and updating::portability and updating
writing good docstrings::writing good docstrings
good docstrings a::good docstrings a
docstrings a sunset::docstrings a sunset
module.  changes::module.  changes
vague and ambiguous::vague and ambiguous
good docstrings describes::good docstrings describes
function does changes::function does changes
sunset.  makes::sunset.  makes
makes a picture::makes a picture
sunset by decreasing::sunset by decreasing
decreasing the green::decreasing the green
green and blue::green and blue
good docstrings makes::good docstrings makes
makes the purpose::makes the purpose
clear and refers::clear and refers
sunset.  takes::sunset.  takes
picture and makes::picture and makes
takes a picture::takes a picture
pic and makes::pic and makes
docstrings be clear::docstrings be clear
returns a value::returns a value
computer the average::computer the average
amount of red::amount of red
picture.  returns::picture.  returns
returns the average::returns the average
good docstrings make::good docstrings make
state any assumptions::state any assumptions
assumptions the function::assumptions the function
function has def::function has def
decreases the amount::decreases the amount
red per pixel::red per pixel
pixel in picture::pixel in picture
pic by int::pic by int
int percent percent::int percent percent
correct use commands::correct use commands
sunset.  take::sunset.  take
take picture pic::take picture pic
pic and make::pic and make
function works makes::function works makes
boolean docstrings def::boolean docstrings def
true if int::true if int
return true iff::return true iff
true iff int::true iff int
iff iff stands::iff iff stands
fact we wrote::fact we wrote
re not returning::re not returning
good docstrings docstrings::good docstrings docstrings
definitions or hints::definitions or hints
hints the docstring::hints the docstring
docstring for sqrt::docstring for sqrt
return the sqrt::return the sqrt
return the square::return the square
marek janicki june::marek janicki june
model from last::model from last
line by line::line by line
counting non-prime factors::counting non-prime factors
considered a factor::considered a factor
worry about lines::worry about lines
nt have intercepts::nt have intercepts
intercepts in general::intercepts in general
worry about inputs::worry about inputs
nt want numbers::nt want numbers
ve seen ints::ve seen ints
reals and booleans::reals and booleans
manipulation and logic::manipulation and logic
type – strings::type – strings
sequences of characters::sequences of characters
characters two types::characters two types
two types str::two types str
str and unicode::str and unicode
ll use str::ll use str
unicode is larger::unicode is larger
strings are denoted::strings are denoted
denoted by single::denoted by single
single or double::single or double
double quotes quote::double quotes quote
quotes quote type::quotes quote type
type must match::type must match
match ! june::match ! june
string operations strings::string operations strings
added we call::added we call
call this concatenation::call this concatenation
concatenation “ str::concatenation “ str
ing ” results::ing ” results
multiply a string::multiply a string
multiplication operator functions::multiplication operator functions
strings using relational::strings using relational
operators can check::operators can check
check if substrings::check if substrings
strings that span::strings that span
span multiple lines::span multiple lines
made using ::made using 
escape characters denoted::escape characters denoted
tab aside len::tab aside len
return an int::return an int
number of characters::number of characters
types to strings::types to strings
print will display::print will display
display the variable::display the variable
display mixed types::display mixed types
print “ string::print “ string
print “ person::print “ person
python to insert::python to insert
insert a type::insert a type
value and format::value and format
float % .2f::float % .2f
pad the float::pad the float
decimal places june::decimal places june
weight we put::weight we put
separated by commas::separated by commas
input using raw_input::input using raw_input
returns a string::returns a string
people s code::people s code
code or make::code or make
bundle up related::bundle up related
group of related::group of related
functions and variables::functions and variables
import it importing::import it importing
importing a module::importing a module
module causes python::module causes python
python to run::python to run
run each line::run each line
line of code::line of code
run a module::run a module
__name__ in addition::__name__ in addition
addition to variables::addition to variables
import a module::import a module
module called module_m::module called module_m
__main__ ” recall::__main__ ” recall
running a module::running a module
things from module_name::things from module_name
module_name import fn_name1::module_name import fn_name1
fn_name1 and fn_name::fn_name1 and fn_name
wildcard to import::wildcard to import
functions from module_name::functions from module_name
recent one stays::recent one stays
methods we ve::methods we ve
functions a similar::functions a similar
thing is true::thing is true
true of values::true of values
values contain ways::values contain ways
call these methods::call these methods
assigned a value::assigned a value
out what methods::out what methods
methods a type::methods a type
methods can find::methods can find
return the number::return the number
number of instances::number of instances
instances of substr::instances of substr
shift to lower::shift to lower
lower case letters::lower case letters
case letters string.upper::case letters string.upper
shift to capitalised::shift to capitalised
capitalised letters june::capitalised letters june
information most direct::information most direct
exist an alternative::exist an alternative
check the standard::check the standard
remember ! functions::remember ! functions
belong to modules::belong to modules
modules methods belong::modules methods belong
belong to objects::belong to objects
types in python::types in python
python are objects::python are objects
covered in greater::covered in greater
subtle but important::subtle but important
important distinction june::important distinction june
repetition often times::repetition often times
times in programs::times in programs
add a number::add a number
reaches some number::reaches some number
execute a block::execute a block
block of code::block of code
condition is true::condition is true
statement this lead::statement this lead
lead to unreadable::lead to unreadable
spaghetti  code::spaghetti  code
goto statement june::goto statement june
loop instead python::loop instead python
python uses loops::python uses loops
loop next week::loop next week
condition is checked::condition is checked
block is skipped::block is skipped
code is executed::code is executed
loops while loops::loops while loops
repeat an action::repeat an action
condition is met::condition is met
action a fixed::action a fixed
number of times::number of times
assignment questions csc::assignment questions csc
questions csc 108h::questions csc 108h
out we ve::out we ve
working on grading::working on grading
testing is key::testing is key
key to developing::key to developing
developing good software::developing good software
good software tests::good software tests
easy to access::easy to access
easy to reuse::easy to reuse
test it based::test it based
writing this means::writing this means
testing two main::testing two main
two main aspects::two main aspects
aspects of testing::aspects of testing
test the tools::test the tools
tests this first::tests this first
largely language independent::largely language independent
types of input::types of input
languages have built-in::languages have built-in
test all inputs::test all inputs
choose a subset::choose a subset
suspect programmer error::suspect programmer error
test boundary conditions::test boundary conditions
picking test cases::picking test cases
break a program::break a program
specifies some kind::specifies some kind
kind of input::kind of input
choose as bad::choose as bad
lots of test::lots of test
build on eachother::build on eachother
great idea note::great idea note
cases that test::cases that test
functions that build::functions that build
ideally one tests::ideally one tests
tests each function::tests each function
test the larger::test the larger
functions that call::functions that call
call the smaller::call the smaller
test a function::test a function
right after writing::right after writing
easiest to fix::easiest to fix
write any code::write any code
code this means::code this means
write the code::write the code
write the tests::write the tests
test professional coders::test professional coders
coders often write::coders often write
write test cases::write test cases
cases before writing::cases before writing
writing code thinking::writing code thinking
thinking about tests::thinking about tests
cases while designing::cases while designing
inform your design::inform your design
summary want individual::summary want individual
individual unit tests::individual unit tests
independent of eachother::independent of eachother
tests before writing::tests before writing
writing code makes::writing code makes
testing in python::testing in python
lot of constraints::lot of constraints
constraints in python::constraints in python
hard to satisfy::hard to satisfy
ve been testing::ve been testing
testing in shell::testing in shell
lot of work::lot of work
write specific code::write specific code
code for opening::code for opening
files and dealing::files and dealing
module called nose::module called nose
nose that helps::nose that helps
testing with nose::testing with nose
nose the context::nose the context
context for testing::context for testing
module named mod::module named mod
create a module::create a module
module called test__mod::module called test__mod
module we import::module we import
body of test__func::body of test__func
assert statements assert::assert statements assert
throw an error::throw an error
false so test__func::false so test__func
bunch of statements::bunch of statements
output the first::output the first
line of output::line of output
tests a dot::tests a dot
dot means pass::dot means pass
means an error::means an error
failure is incorrect::failure is incorrect
kind each failure::kind each failure
failure or error::failure or error
error produces information::error produces information
error the last::error the last
last bit tells::last bit tells
number of tests::number of tests
number of errors::number of errors
output the information::output the information
information that python::information that python
fail a test::fail a test
add some information::add some information
assert statement assert::assert statement assert
nose and testing::nose and testing
testing unit tests::testing unit tests
tests each test::tests each test
test in nose::test in nose
write a function::write a function
designing tests early::designing tests early
function the tests::function the tests
tests treat functions::tests treat functions
black box regression::black box regression
box regression testing::box regression testing
regression testing nose::regression testing nose
testing nose makes::testing nose makes
easy to run::easy to run
find an error::find an error
ways to mitigate::ways to mitigate
mitigate this pain::mitigate this pain
early ! test::early ! test
test often find::test often find
find the first::find the first
head to make::head to make
code will work::code will work
read the error::read the error
code is correct::code is correct
parts the functions::parts the functions
game_summary and strip_tag_info::game_summary and strip_tag_info
function that game::function that game
game summary calls::game summary calls
problem of recording::problem of recording
recording the moves::recording the moves
moves and boards::moves and boards
state are intertwined::state are intertwined
component chunks chunk::component chunks chunk
parsing the input::parsing the input
done by get_move_lst::done by get_move_lst
get_move_lst and get_move_str::get_move_lst and get_move_str
individual move text::individual move text
extract a bunch::extract a bunch
bit of information::bit of information
bunch of functions::bunch of functions
solution other things::solution other things
supposed to return::supposed to return
place a piece::place a piece
piece could move::piece could move
legally this code::legally this code
comments and questions::comments and questions
assignment at office::assignment at office
tuesday that week::tuesday that week
week the midterm::week the midterm
regular lecture room::regular lecture room
lecture room june::lecture room june
class who requires::class who requires
requires a volunteer::requires a volunteer
disability by signing::disability by signing
posting your notes::posting your notes
make a significant::make a significant
individual s capacity::individual s capacity
person to accessibility::person to accessibility
huron st suite::huron st suite
notice the quality::notice the quality
improves through volunteering::improves through volunteering
receive a certificate::receive a certificate
certificate of recognition::certificate of recognition
change an immutable::change an immutable
things like ints::things like ints
ints and strings::ints and strings
takes a lot::takes a lot
things like images::things like images
object without keeping::object without keeping
keeping the original::keeping the original
making a big::making a big
tossing the rest::tossing the rest
rest is wasteful::rest is wasteful
allowed to change::allowed to change
functions that change::functions that change
ints are immutable::ints are immutable
aliasing let pic::aliasing let pic
sets the green::sets the green
pics are mutable::pics are mutable
show a picture::show a picture
aliasing and functions::aliasing and functions
calls a function::calls a function
bunch of assignment::bunch of assignment
parameters are assigned::parameters are assigned
local variable refers::local variable refers
functions can change::functions can change
change mutable objects::change mutable objects
immutable ones june::immutable ones june
slow in high-dimensional::slow in high-dimensional
high-dimensional spaces python::high-dimensional spaces python
grouping similar items::grouping similar items
i-1 because lists::i-1 because lists
lists are indexed::lists are indexed
element list named::element list named
list named list_name::list named list_name
lists are mutable::lists are mutable
index into lists::index into lists
lists are heterogeneous::lists are heterogeneous
lists themselves june::lists themselves june
functions and methods::functions and methods
returns the length::returns the length
return the min::return the min
min and max::min and max
returns the sum::returns the sum
sum of elements::sum of elements
numbered not defined::numbered not defined
defined for lists::defined for lists
lists of strings::lists of strings
adds the value::adds the value
sorts the list::sorts the list
inserts the element::inserts the element
index specified remove::index specified remove
removes the first::removes the first
instance of value::instance of value
counts the number::counts the number
instances of value::instances of value
looping over lists::looping over lists
loops for item::loops for item
item in list::item in list
item = list::item = list
tricky with immutable::tricky with immutable
objects for item::objects for item
item is immutable::item is immutable
alter the list::alter the list
returns an ordered::returns an ordered
list of ints::list of ints
j-1 inclusive range::j-1 inclusive range
returns a list::returns a list
ints so range::ints so range
modify a list::modify a list
element by element::element by element
makes a list::makes a list
beginning to j-1::beginning to j-1
worried about aliasing::worried about aliasing
make a tuple::make a tuple
items are referenced::items are referenced
referenced by tuple_name::referenced by tuple_name
single element tuples::single element tuples
strings revisted strings::strings revisted strings
tuples of individual::tuples of individual
strings can reference::strings can reference
reference individual characters::reference individual characters
characters by string::characters by string
defined on strings::defined on strings
string methods revisted::string methods revisted
index into strings::index into strings
string methods find::string methods find
give the index::give the index
matching the substring::matching the substring
character exists rfind::character exists rfind
lists because lists::lists because lists
lists of lists::lists of lists
represent a grid::represent a grid
grid or higher::grid or higher
higher dimenstional space::higher dimenstional space
elements by list_name::elements by list_name
item in list_name::item in list_name
item2 in item::item2 in item
computer programming::computer programming
programming summer::programming summer
marek janicki::marek janicki
administration office::administration office
office hours::office hours
hours held::hours held
thursday tutorials::thursday tutorials
website typo::website typo
info sheet::info sheet
simple assignment::simple assignment
cdf machines::cdf machines
compared programs::compared programs
accurate programs::accurate programs
last week::last week
vice versa::vice versa
returns false::returns false
truth tables::truth tables
boolean expressions::boolean expressions
true true::true true
true false::true false
false false::false false
false true::false true
boolean values::boolean values
relational operators::relational operators
comparison operators::comparison operators
return true::return true
equality operator::equality operator
boolean operators::boolean operators
arithmetic operators::arithmetic operators
legal expression::legal expression
boolean false::boolean false
avoid exploiting::avoid exploiting
short circuit::short circuit
circuit evaluation::circuit evaluation
evaluation python::evaluation python
boolean expression::boolean expression
boolean representation::boolean representation
strange behaviour::strange behaviour
behaviour exploiting::behaviour exploiting
bad style::bad style
boolean variables::boolean variables
variables recall::variables recall
code adaptive::code adaptive
execute blocks::execute blocks
general form::general form
expression recall::expression recall
python statements::python statements
condition evaluates::condition evaluates
code based::code based
elif condition2::elif condition2
elif condition3::elif condition3
block python::block python
python evalutates::python evalutates
style advice::style advice
complicated expressions::complicated expressions
expressions simplify::expressions simplify
double negatives::double negatives
native functions::native functions
call functions::call functions
reuse bits::reuse bits
parse information::parse information
human mind::human mind
function names::function names
print recall::print recall
functions end::functions end
return statement::return statement
keyword return::keyword return
function returns::function returns
print statement::print statement
statement print::statement print
print takes::print takes
expressions separated::expressions separated
multiple function::multiple function
function calls::function calls
functions calling::functions calling
local variables::local variables
python choose::python choose
choose variables::choose variables
global variables::global variables
defined inside::defined inside
local variable::local variable
global variable::global variable
variables defined::variables defined
enclosing function::enclosing function
built-in variables::built-in variables
local namespace::local namespace
enclosing functions::enclosing functions
global namespace::global namespace
style conventions::style conventions
call variables::call variables
variables exploiting::variables exploiting
makes code::makes code
designing functions::designing functions
choose parameters::choose parameters
global parameters::global parameters
return functions::return functions
return information::return information
function documentation::function documentation
documentation recall::documentation recall
built-in function::built-in function
first line::first line
docstring short::docstring short
documentation string::documentation string
string python::string python
python saves::python saves
blank line::blank line
instant sanity::instant sanity
sanity check::sanity check
makes portability::makes portability
updating easier::updating easier
good chunking::good chunking
good docstrings::good docstrings
docstrings a::docstrings a
a sunset::a sunset
terrible docstrings::terrible docstrings
function expects::function expects
docstrings describes::docstrings describes
function works::function works
unnecessary information::unnecessary information
function makes::function makes
docstrings makes::docstrings makes
parameter clear::parameter clear
picture pic::picture pic
average amount::average amount
picture pic.::picture pic.
docstrings make::docstrings make
explicitly state::explicitly state
def decrease_red::def decrease_red
int percent::int percent
percent percent::percent percent
grammatically correct::grammatically correct
descriptions takes::descriptions takes
take picture::take picture
works makes::works makes
boolean docstrings::boolean docstrings
docstrings def::docstrings def
return true::return true
true iff::true iff
iff int::iff int
iff iff::iff iff
iff stands::iff stands
boolean functions::boolean functions
return false::return false
returning true::returning true
docstrings docstrings::docstrings docstrings
include definitions::include definitions
square root::square root
janicki june::janicki june
administration questions::administration questions
memory model::memory model
file posted::file posted
lectures page::lectures page
announcements june::announcements june
non-prime factors::non-prime factors
acceptable answer::acceptable answer
answer june::answer june
number manipulation::number manipulation
logic manipulation::logic manipulation
strings june::strings june
strings sequences::strings sequences
types str::types str
roman alphabet::roman alphabet
symbols unicode::symbols unicode
accented letters::accented letters
chinese characters::chinese characters
double quotes::double quotes
quotes quote::quotes quote
quote type::quote type
string operations::string operations
operations strings::operations strings
multiplication operator::multiplication operator
operator functions::operator functions
compare strings::compare strings
span multiple::span multiple
multiple lines::multiple lines
 june:: june
escape characters::escape characters
characters denoted::characters denoted
special character::special character
single quote::single quote
double quote::double quote
string june::string june
converting types::converting types
string print::string print
mixed types::mixed types
awkward print::awkward print
weight june::weight june
string formatting::string formatting
special characters::special characters
tells python::tells python
decimal places::decimal places
places june::places june
multiple variables::multiple variables
parentheses separated::parentheses separated
commas print::commas print
user input::user input
giving input::giving input
code inefficient::code inefficient
user-friendly python::user-friendly python
converted june::converted june
first june::first june
related functions::related functions
file modules::file modules
variables june::variables june
function definitions::function definitions
prefix june::prefix june
import things::import things
module_name import::module_name import
import fn_name1::import fn_name1
stays june::stays june
similar thing::similar thing
values values::values values
string methods::string methods
string string.lower::string string.lower
lower case::lower case
case letters::case letters
letters string.upper::letters string.upper
capitalised letters::capitalised letters
letters june::letters june
method information::method information
nt searchable::nt searchable
standard library::standard library
skill june::skill june
modules methods::modules methods
methods belong::methods belong
basic types::basic types
greater detail::greater detail
function str.lower::function str.lower
method subtle::method subtle
important distinction::important distinction
distinction june::distinction june
true ages::true ages
goto statement::goto statement
unreadable spaghetti::unreadable spaghetti
code python::code python
statement june::statement june
checked first::checked first
block executes::block executes
executed june::executed june
fixed number::fixed number
times june::times june
assignment questions::assignment questions
questions csc::questions csc
administration assignment::administration assignment
testing testing::testing testing
good software::good software
software tests::software tests
testing i.e::testing i.e
test code::test code
actual code::actual code
re writing::re writing
main aspects::main aspects
run tests::run tests
first aspect::first aspect
largely language::largely language
language independent::language independent
common paradigm::common paradigm
built-in tools::built-in tools
test cases::test cases
typical inputs::typical inputs
test things::test things
suspect programmer::suspect programmer
programmer error::programmer error
boundary conditions::boundary conditions
picking test::picking test
docstring specifies::docstring specifies
bad inputs::bad inputs
great idea::great idea
idea note::idea note
test functions::test functions
function individually::function individually
unit testing::unit testing
smaller functions::smaller functions
larger functions::larger functions
regression testing::regression testing
fix things::fix things
black-box fashion::black-box fashion
test professional::test professional
professional coders::professional coders
write test::write test
writing code::writing code
code thinking::code thinking
tests cases::tests cases
design tool::design tool
design makes::design makes
robust code::robust code
testing summary::testing summary
individual unit::individual unit
unit tests::unit tests
chosen adversarially::chosen adversarially
design tests::design tests
code makes::code makes
style tests::style tests
rerun tests::rerun tests
change code::change code
python testing::python testing
specific code::specific code
opening files::opening files
luckily python::luckily python
module named::module named
named mod::named mod
import nose::import nose
import mod::import mod
function func::function func
assert statements::assert statements
statements assert::statements assert
boolean condition::boolean condition
assert func::assert func
nose runs::nose runs
produces output::produces output
nose output::nose output
output tells::output tells
dot means::dot means
means pass::means pass
means fail::means fail
incorrect output::incorrect output
error produces::error produces
produces information::produces information
last bit::last bit
bit tells::bit tells
tests passes::tests passes
tests failed::tests failed
error information::error information
assert statement::assert statement
statement assert::statement assert
testing unit::testing unit
unit test::unit test
designing tests::designing tests
tests early::tests early
tests treat::tests treat
treat functions::treat functions
black box::black box
box regression::box regression
testing nose::testing nose
nose makes::nose makes
pain test::pain test
first point::first point
code differs::code differs
work read::work read
algebraic notation::algebraic notation
parts game_summary::parts game_summary
part strip_tag_info::part strip_tag_info
game summary::game summary
summary calls::summary calls
boards state::boards state
component chunks::component chunks
chunks chunk::chunks chunk
moves done::moves done
individual move::individual move
move text::move text
nested list::nested list
piece started::piece started
code relies::code relies
hours assignment::hours assignment
held monday::held monday
held june::held june
regular lecture::regular lecture
lecture room::lecture room
room june::room june
volunteer note-taker::volunteer note-taker
volunteer notetaker::volunteer notetaker
significant difference::significant difference
accessibility services::accessibility services
students notice::students notice
notetaking improves::notetaking improves
recognition june::recognition june
immutable objects::immutable objects
nt change::nt change
immutable object::immutable object
small things::small things
large things::large things
images june::images june
mutable objects::mutable objects
large object::large object
big copy::big copy
mutable object::mutable object
define functions::define functions
change objects::change objects
immutable june::immutable june
initialised picture::initialised picture
green june::green june
assignment statements::assignment statements
variable refers::variable refers
lists recall::lists recall
high-dimensional spaces::high-dimensional spaces
spaces python::spaces python
similar items::similar items
list denoted::list denoted
i-th element::i-th element
element list::element list
list named::list named
named list_name::named list_name
mutable june::mutable june
empty list::empty list
back list_name::back list_name
back lists::back lists
functions lists::functions lists
methods len::methods len
list min::list min
defined sum::defined sum
re numbered::re numbered
methods append::methods append
list sort::list sort
consistent notions::consistent notions
element value::element value
first instance::first instance
value count::value count
list june::list june
similar operation::similar operation
list python::list python
block item::block item
lists loops::lists loops
list elements::list elements
function range::function range
ordered list::ordered list
ints ranging::ints ranging
i-1 range::i-1 range
inclusive range::inclusive range
list element::list element
block june::block june
list slicing::list slicing
perform operations::perform operations
aliasing carelessness::aliasing carelessness
tuple tuple_name::tuple tuple_name
single element::single element
element tuples::element tuples
avoid ambiguity::avoid ambiguity
strings revisted::strings revisted
revisted strings::revisted strings
considered tuples::considered tuples
individual characters::individual characters
list knowlege::list knowlege
characters min::characters min
slice strings::slice strings
lists june::lists june
methods revisted::methods revisted
methods find::methods find
first character::first character
character exists::character exists
exists rfind::exists rfind
right find::right find
nested lists::nested lists
higher dimenstional::higher dimenstional
dimenstional space::dimenstional space
reference elements::reference elements
nested loops::nested loops
block csc::block csc
csc::csc
108h::108h
introduction::introduction
computer::computer
programming::programming
summer::summer
marek::marek
janicki::janicki
administration::administration
office::office
hours::hours
held::held
t12-2::t12-2
f2-4::f2-4
posted::posted
announcements::announcements
people::people
thursday::thursday
tutorials::tutorials
switching::switching
class::class
ba1170::ba1170
june::june
23rd::23rd
july::july
14th::14th
website::website
typo::typo
info::info
sheet::sheet
trailing::trailing
redirect::redirect
added::added
e-mail::e-mail
quellan::quellan
cs.toronto.edu::cs.toronto.edu
cdf.toronto.edu::cdf.toronto.edu
assignment::assignment
short::short
simple::simple
done::done
write::write
submit::submit
make::make
runs::runs
cdf::cdf
machines::machines
questions::questions
accepted::accepted
2nd::2nd
programs::programs
adaptive::adaptive
last::last
compared::compared
recipes::recipes
accurate::accurate
behave::behave
differently::differently
depending::depending
situation::situation
snippet::snippet
week::week
booleans::booleans
type::type
two::two
values::values
true::true
false::false
operations::operations
vice::vice
versa::versa
returns::returns
arguments::arguments
truth::truth
tables::tables
representing::representing
boolean::boolean
expressions::expressions
adapatively::adapatively
assign::assign
relational::relational
operators::operators
comparison::comparison
return::return
equality::equality
operator::operator
equals::equals
representation::representation
combine::combine
,etc::,etc
arithmetic::arithmetic
1-2::1-2
2-4::2-4
legal::legal
expression::expression
represented::represented
lead::lead
weirdness::weirdness
avoid::avoid
exploiting::exploiting
circuit::circuit
evaluation::evaluation
python::python
evaluates::evaluates
long::long
answer::answer
clear::clear
stop::stop
combined::combined
nature::nature
strange::strange
behaviour::behaviour
behaviours::behaviours
bad::bad
style::style
variables::variables
recall::recall
code::code
selectively::selectively
execute::execute
blocks::blocks
statements::statements
statement::statement
general::general
form::form
condition::condition
block::block
grade::grade
print::print
pass::pass
series::series
executed::executed
forms::forms
lines::lines
based::based
outcome::outcome
condition1::condition1
elif::elif
condition2::condition2
condition3::condition3
evalutates::evalutates
conditions::conditions
order::order
executes::executes
first::first
final::final
optional::optional
advice::advice
unsure::unsure
precedence::precedence
parentheses::parentheses
easier::easier
reader::reader
complicated::complicated
simplify::simplify
rid::rid
double::double
negatives::negatives
break::break
review::review
functions::functions
started::started
native::native
call::call
define::define
reuse::reuse
bits::bits
makes::makes
updating::updating
testing::testing
test::test
update::update
function::function
place::place
chunking::chunking
parse::parse
information::information
human::human
mind::mind
pretty::pretty
limited::limited
names::names
shorthand::shorthand
end::end
value::value
keyword::keyword
ve::ve
snippets::snippets
takes::takes
separated::separated
prints::prints
screen::screen
identical::identical
shell::shell
multiple::multiple
calls::calls
calling::calling
case::case
inside::inside
out::out
rule::rule
apply::apply
result::result
local::local
choose::choose
global::global
defined::defined
inside::inside
variable::variable
generally::generally
check::check
enclosing::enclosing
finally::finally
built-in::built-in
scope::scope
namespaces::namespaces
space::space
area::area
create::create
namespace::namespace
conventions::conventions
careless::careless
initialise::initialise
hard::hard
read::read
prone::prone
errors::errors
designing::designing
parameters::parameters
passed::passed
parameter::parameter
rely::rely
show::show
user::user
nt::nt
media.show::media.show
documentation::documentation
modules::modules
give::give
add::add
docstrings::docstrings
docstring::docstring
surrounded::surrounded
line::line
module::module
string::string
saves::saves
convention::convention
leave::leave
blank::blank
instant::instant
sanity::sanity
doing::doing
portability::portability
good::good
writing::writing
a::a
sunset::sunset
module.::module.
changes::changes
sunset.::sunset.
terrible::terrible
vague::vague
ambiguous::ambiguous
expects::expects
describes::describes
makes::makes
picture::picture
decreasing::decreasing
green::green
blue::blue
.::.
describe::describe
works::works
unnecessary::unnecessary
re::re
purpose::purpose
refers::refers
takes::takes
pic::pic
average_red::average_red
computer::computer
average::average
amount::amount
red::red
picture.::picture.
returns::returns
float::float
pic.::pic.
explicitly::explicitly
state::state
assumptions::assumptions
def::def
decrease_red::decrease_red
pic,percent::pic,percent
decreases::decreases
pixel::pixel
int::int
percent::percent
100.::100.
concise::concise
grammatically::grammatically
correct::correct
commands::commands
descriptions::descriptions
take::take
is_odd::is_odd
return::return
odd::odd
otherwise.::otherwise.
commonly::commonly
shortened::shortened
iff::iff
stands::stands
fact::fact
wrote::wrote
odd.::odd.
understood::understood
returning::returning
include::include
definitions::definitions
hints::hints
sqrt::sqrt
number::number
multiplied::multiplied
simply::simply
square::square
root::root
memory::memory
model::model
file::file
lectures::lectures
page::page
find_factor::find_factor
exclusive::exclusive
means::means
counting::counting
non-prime::non-prime
factors::factors
acceptable::acceptable
considered::considered
factor::factor
input::input
find::find
intercept::intercept
worry::worry
intercepts::intercepts
inputs::inputs
numbers::numbers
ints::ints
reals::reals
manipulation::manipulation
logic::logic
text::text
strings::strings
sequences::sequences
characters::characters
types::types
str::str
unicode::unicode
ll::ll
roman::roman
alphabet::alphabet
symbols::symbols
larger::larger
accented::accented
letters::letters
chinese::chinese
denoted::denoted
single::single
quotes::quotes
quote::quote
match::match
added::added
concatenation::concatenation
ing::ing
results::results
sort::sort
multiply::multiply
multiplication::multiplication
copy::copy
copycopycopy::copycopycopy
compare::compare
substrings::substrings
span::span
made::made
::
escape::escape
backslash::backslash
character::character
special::special
tab::tab
len::len
converting::converting
convert::convert
display::display
mixed::mixed
real_num::real_num
awkward::awkward
person::person
height::height
age::age
weight::weight
formatting::formatting
insert::insert
tells::tells
format::format
integer::integer
.2f::.2f
pad::pad
decimal::decimal
places::places
put::put
commas::commas
program::program
running::running
giving::giving
hardcode::hardcode
inefficient::inefficient
user-friendly::user-friendly
raw_input::raw_input
converted::converted
convenient::convenient
bundle::bundle
related::related
group::group
import::import
importing::importing
run::run
trouble::trouble
annoying::annoying
care::care
module_name.function_name::module_name.function_name
function_name::function_name
__name__::__name__
addition::addition
module_m::module_m
module_m.__name__::module_m.__name__
__main__::__main__
prefix::prefix
things::things
module_name::module_name
fn_name1::fn_name1
fn_name2::fn_name2
fn_name::fn_name
referred::referred
wildcard::wildcard
recent::recent
stays::stays
methods::methods
similar::similar
thing::thing
ways::ways
modify::modify
value.fn_name::value.fn_name
assigned::assigned
variable_name.fn_name::variable_name.fn_name
figure::figure
s.replace::s.replace
instances::instances
replaced::replaced
string.count::string.count
substr::substr
string.lower::string.lower
shift::shift
lower::lower
string.upper::string.upper
capitalised::capitalised
method::method
direct::direct
searchable::searchable
dir::dir
browse::browse
exist::exist
alternative::alternative
standard::standard
library::library
http::http
skill::skill
remember::remember
belong::belong
objects::objects
basic::basic
learn::learn
covered::covered
greater::greater
detail::detail
str.lower::str.lower
subtle::subtle
important::important
distinction::distinction
repetition::repetition
times::times
reaches::reaches
ages::ages
ago::ago
goto::goto
unreadable::unreadable
spaghetti::spaghetti
loop::loop
loops::loops
cover::cover
checked::checked
skipped::skipped
repeat::repeat
action::action
indefinitely::indefinitely
met::met
fixed::fixed
autograder::autograder
working::working
grading::grading
key::key
developing::developing
software::software
tests::tests
easy::easy
access::access
separate::separate
i.e::i.e
actual::actual
main::main
aspects::aspects
figuring::figuring
tools::tools
aspect::aspect
largely::largely
language::language
independent::independent
languages::languages
common::common
paradigm::paradigm
cases::cases
subset::subset
representative::representative
typical::typical
inputs::inputs
suspect::suspect
programmer::programmer
error::error
boundary::boundary
overlooked::overlooked
adversarially::adversarially
picking::picking
adversary::adversary
cheating::cheating
specifies::specifies
kind::kind
limit::limit
source::source
failure::failure
lots::lots
build::build
eachother::eachother
great::great
idea::idea
note::note
ideally::ideally
individually::individually
unit::unit
smaller::smaller
tested::tested
regression::regression
right::right
easiest::easiest
fix::fix
point::point
structure::structure
black-box::black-box
fashion::fashion
professional::professional
coders::coders
thinking::thinking
design::design
tool::tool
inform::inform
robust::robust
summary::summary
individual::individual
generic::generic
chosen::chosen
adversarially::adversarially
rerun::rerun
change::change
lot::lot
constraints::constraints
satisfy::satisfy
work::work
store::store
specific::specific
opening::opening
files::files
dealing::dealing
luckily::luckily
nose::nose
helps::helps
context::context
named::named
mod::mod
test__mod::test__mod
func::func
test__func::test__func
__main__::__main__
nose.runmodule::nose.runmodule
body::body
assert::assert
throw::throw
bunch::bunch
expected_output::expected_output
produces::produces
output::output
dot::dot
fail::fail
incorrect::incorrect
exception::exception
bit::bit
passes::passes
failed::failed
back::back
assertionerror::assertionerror
early::early
specifiction::specifiction
treat::treat
black::black
box::box
debug::debug
process::process
painful::painful
mitigate::mitigate
pain::pain
differs::differs
head::head
solution::solution
conceptually::conceptually
parts::parts
algebraic::algebraic
notation::notation
game_summary::game_summary
strip_tag_info::strip_tag_info
part::part
game::game
rest::rest
problem::problem
recording::recording
moves::moves
boards::boards
intertwined::intertwined
big::big
component::component
chunks::chunks
chunk::chunk
parsing::parsing
get_move_lst::get_move_lst
get_move_str::get_move_str
move::move
extract::extract
mate::mate
get_fin_sq::get_fin_sq
get_piece_type::get_piece_type
track::track
board::board
update_board::update_board
get_init_move::get_init_move
move_piece::move_piece
nested::nested
list::list
supposed::supposed
piece::piece
pieces::pieces
legally::legally
relies::relies
heavily::heavily
correctness::correctness
comments::comments
weekend::weekend
deadline::deadline
moved::moved
27th::27th
monday::monday
tuesday::tuesday
midterm::midterm
30th::30th
regular::regular
lecture::lecture
room::room
request::request
volunteer::volunteer
note-taker::note-taker
student::student
requires::requires
notetaker::notetaker
accommodation::accommodation
disability::disability
signing::signing
posting::posting
notes::notes
significant::significant
difference::difference
capacity::capacity
fully::fully
participate::participate
accessibility::accessibility
services::services
huron::huron
suite::suite
students::students
notice::notice
quality::quality
notetaking::notetaking
improves::improves
volunteering::volunteering
receive::receive
certificate::certificate
recognition::recognition
immutable::immutable
making::making
object::object
small::small
large::large
images::images
mutable::mutable
keeping::keeping
original::original
modifying::modifying
tossing::tossing
wasteful::wasteful
allowed::allowed
aliasing::aliasing
initialised::initialised
sets::sets
media.set_green::media.set_green
pixel,0::pixel,0
pics::pics
effectively::effectively
beginning::beginning
lists::lists
co-ordinate::co-ordinate
easily::easily
slow::slow
high-dimensional::high-dimensional
spaces::spaces
grouping::grouping
items::items
list_name::list_name
list_elt0::list_elt0
list_elt1::list_elt1
list_eltn::list_eltn
i-th::i-th
element::element
i-1::i-1
indexed::indexed
elements::elements
empty::empty
index::index
heterogeneous::heterogeneous
length::length
min::min
max::max
sum::sum
numbered::numbered
append::append
adds::adds
sorts::sorts
consistent::consistent
notions::notions
inserts::inserts
remove::remove
removes::removes
instance::instance
count::count
counts::counts
looping::looping
operation::operation
item::item
equivalent::equivalent
tricky::tricky
alter::alter
indices::indices
range::range
ordered::ordered
ranging::ranging
i,j::i,j
j-1::j-1
inclusive::inclusive
i,j,k::i,j,k
step::step
i,k::i,k
i,k,1::i,k,1
slicing::slicing
perform::perform
sublist::sublist
aliased::aliased
tuples::tuples
worried::worried
carelessness::carelessness
tuple::tuple
tuple_name::tuple_name
item0,item1,item2::item0,item1,item2,
referenced::referenced
ambiguity::ambiguity
revisted::revisted
knowlege::knowlege
gained::gained
reference::reference
heterogenous::heterogenous
slice::slice
substring::substring
matching::matching
left::left
exists::exists
rfind::rfind
substring,i,j::substring,i,j
matrices::matrices
represent::represent
grid::grid
higher::higher
dimenstional::dimenstional
naturally::naturally
item2::item2
