caching is discussed::caching is discussed
discussed by mckeon::discussed by mckeon
experimental sprite operating::experimental sprite operating
sprite operating system::sprite operating system
system is described::system is described
described in nelson::described in nelson
discussions concerning mass-storage::discussions concerning mass-storage
technology are offered::technology are offered
offered by chi::offered by chi
folk and zoellick::folk and zoellick
covers the gamut::covers the gamut
gamut of file::gamut of file
file structures silvers::file structures silvers
implementing the page::implementing the page
netbsd operating system::netbsd operating system
network file system::network file system
discussed in sandberg::discussed in sandberg
described at http::described at http
disk caching::disk caching
experimental sprite::experimental sprite
sprite operating::sprite operating
operating system::operating system
general discussions::general discussions
mass-storage technology::mass-storage technology
file structures::file structures
structures silvers::structures silvers
discusses implementing::discusses implementing
page cache::page cache
netbsd operating::netbsd operating
network file::network file
file system::file system
nfs version::nfs version
disk::disk
caching::caching
discussed::discussed
mckeon::mckeon
smith::smith
experimental::experimental
sprite::sprite
operating::operating
system::system
described::described
nelson::nelson
general::general
discussions::discussions
mass-storage::mass-storage
technology::technology
offered::offered
chi::chi
hoagland::hoagland
folk::folk
zoellick::zoellick
covers::covers
gamut::gamut
file::file
structures::structures
silvers::silvers
discusses::discusses
implementing::implementing
page::page
cache::cache
netbsd::netbsd
network::network
nfs::nfs
sandberg::sandberg
sun::sun
callaghan::callaghan
version::version
standard::standard
http::http
characteristics::characteristics
